_id,CODIGO,DESCRIPCIÓN,TIPO DE COMPRA,PRECIO UNITARIO B/.,CANTIDAD EXISTENCIA ALMACÉN CDPA SEPTIEMBRE,CANTIDAD EXISTENCIA ALMACÉN CDDI SEPTIEMBRE,CANTIDAD EXISTENCIA ALMACÉN CDCH SEPTIEMBRE,TOTAL DE EXISTENCIAS  DISPONIBLES    SEPTIEMBRE,MONTO DE EXISTENCIAS EN B/.
1,209003502,CONECTOR PARA BOMBA DE INFUSION CON FILTRO DE AIRE,TRAMITE USUAL,4.4900000000000002131628207280300557613372802734375,61660,18800,11600,92060,413349.400000000023283064365386962890625
2,209003700,AGUJA PARA NEUMOPERITONEO  (TIPO VERESS) PARA LAPARASCOPIA (Se solicita 120mm),TRAMITE USUAL,10.16499999999999914734871708787977695465087890625,0,0,0,0,0
3,209007502,DETERGENTE ANIONICO EN POLVO PRESENTACION: PAQ. DE 4 LIBRAS,TRAMITE USUAL,35.49846000000000145746525959111750125885009765625,7302,360,342,8004,284129.6738400000031106173992156982421875
4,209008100,"AGUJA HIPODÉRMICA,  (SE SOLICITA CALIBRE 18G X 1  1/2 PULGADAS, 38MM DE LONGITUD)",TRAMITE USUAL,0.008859999999999999820143870010724640451371669769287109375,0,0,0,0,0
5,209008400,"AGUJA HIPODÉRMICA,   (SE SOLICITA CALIBRE 21G, 1 PULGADAS, 25MM DE LONGITUD.) ",TRAMITE USUAL,0.01499999999999999944488848768742172978818416595458984375,440000,28600,31600,500200,7503
6,209008500,"AGUJA HIPODÉRMICA,  SE SOLICITA CALIBRE 21G X 1 1/2 PULGADAS, 38MM DE LONGITUD",TRAMITE USUAL,0.00821999999999999987621013275429504574276506900787353515625,0,500,0,500,4.11000000000000031974423109204508364200592041015625
7,209008600,"AGUJA HIPODÉRMICA, SE SOLICITA CALIBRE 22G X 1 PULGADAS, 25MM DE LONGITUD",TRAMITE USUAL,0.02004999999999999837907438404727145098149776458740234375,0,0,0,0,0
8,209008700,"AGUJA HIPODÉRMICA    (SE SOLICITA CALIBRE 22G X 1 1/2 PULGADAS, 38MM DE LONGITUD)",TRAMITE USUAL,0.025000000000000001387778780781445675529539585113525390625,155000,146100,29400,330500,8262.5
9,209008800,"AGUJA HIPODÉRMICA, (SE SOLICITA CALIBRE 23G X 1 PULGADAS 25MM DE LONGITUD)",TRAMITE USUAL,0.00821999999999999987621013275429504574276506900787353515625,0,0,0,0,0
10,209008900,"AGUJA HIPODÉRMICA,   SE SOLICITA CALIBRE 24G X 1 PULGADAS 25MM DE LONGITUD",TRAMITE USUAL,0.01499999999999999944488848768742172978818416595458984375,0,0,0,0,0
11,209009000,"AGUJA HIPODÉRMICA DESECHABLE (Se solicita calibre 25G de 1"" de longitud) ",TRAMITE USUAL,0.0200000000000000004163336342344337026588618755340576171875,0,0,0,0,0
12,209009002,"AGUJA HIPODÉRMICA    (SE SOLICITA CALIBRE 25G X 1 1/2 PULGADAS, 38MM DE LONGITUD)",TRAMITE USUAL,0.0200000000000000004163336342344337026588618755340576171875,1239000,53100,38300,1330400,26608
13,209009301,"PAPEL SATINADO PARA CAMILLA Y MESA DE EXAMEN. (SE SOLICITA TAMAÑO 18"" ANCHO X 300 PIES LARGO)",TRAMITE USUAL,3.8300000000000000710542735760100185871124267578125,0,0,0,0,0
14,209011222,BANDEJA PARA CATETERIZACION VENOSA CENTRAL TRIPLE LUMEN.  SE SOLICITA CATETER DE POLIURETANO,TRAMITE USUAL,60.5,0,0,0,0,0
15,209011226,BANDEJA PARA CATETERIZACION VENOSO CENTRAL TRIPLE LUMEN CON 2 ANTIBIOTICOS (MINOCICLINA Y RIFAMPICINA).                                                                      (SE SOLICITA CATETER DE POLIURETANO ADULTO),TRAMITE USUAL,262.5,0,0,0,0,0
16,209013300,RECIPIENTE DESECHABLE PARA SISTEMA DE DRENAJE TORÁCICO DIGITAL (Se solicita de 800cc de capacidad),TRAMITE USUAL,22.72276000000000095724317361600697040557861328125,3532,0,12,3544,80529.461439999999129213392734527587890625
17,209013400,TUBO PARA SISTEMA DE DRENAJE TORÁCICO DIGITAL CONEXIÓN DOBLE (Se solicita longitud de 1.5 mts). DEBE SER COMPATIBLE CON EL EQUIPO EXISTENTE EN LA INSTITUCIÓN.,TRAMITE USUAL,23.6099999999999994315658113919198513031005859375,0,0,0,0,0
18,209016801,ESPONJA HEMOSTATICA DE GELATINA ABSORBIBLE.   SE SOLICITA TAMAÑO 7x5x1CM ( 70MMX50MMX10MM ),TRAMITE USUAL,3.089999999999999857891452847979962825775146484375,0,0,0,0,0
19,209017402,JALEA LUBRICANTE ESTÉRIL  (SE SOLICITA TUBO DE 113 GM),TRAMITE USUAL,3.149999999999999911182158029987476766109466552734375,0,0,0,0,0
20,209018401,TRAJE DE PROTECCION PERSONAL (TIPO OVEROL) TAMAÑO L,TRAMITE USUAL,10.7599999999999997868371792719699442386627197265625,629032,8160,0,637192,6856185.91999999992549419403076171875
21,209018501,TRAJE DE PROTECCION PERSONAL (TIPO OVEROL)TAMAÑO XL,TRAMITE USUAL,10.7599999999999997868371792719699442386627197265625,515330,0,1550,516880,5561628.799999999813735485076904296875
22,209018800,"APLICADOR DE GRAPAS AUTOMÁTICO PARA LAPAROSCOPIA (Se solicita con grapa de 10mm, 20 grapas, mediano / grande)",TRAMITE USUAL,70,0,0,0,0,0
23,209018801,"APLICADOR DE GRAPAS AUTOMÁTICO PARA LAPAROSCOPIA  (SE SOLICITA TAMAÑO DE 5MM, 20 GRAPAS, MEDIANO / GRANDE)",TRAMITE USUAL,137.5,0,0,0,0,0
24,209019006,"VENDA DE GASA PRESATURADAS DE CLORURO DE SODIO AL 20%   (TAMAÑO 6"" (15 CM ) X 6 3/4"" (17 CM ).",TRAMITE USUAL,5.12366000000000010317080523236654698848724365234375,0,0,0,0,0
25,209019200,"APLICADOR DE MADERA CON ALGODÓN, ESTÉRIL  (SE SOLICITA DE 6"")",TRAMITE USUAL,0.0299999999999999988897769753748434595763683319091796875,4600,56400,58200,119200,3576
26,209019501,APÓSITO HIDROCOLOIDE (FINO O EXTRA DELGADO)          (SE SOLICITA CUADRADO 15CM X 15CM).,TRAMITE USUAL,2.7050000000000000710542735760100185871124267578125,0,0,0,0,0
27,209019502,"APÓSITO HIDROCOLOIDE (Estándar, Regular o Extra Absorbente)                (SE SOICITA CUADRADO/IMPERMEABLE 20CM X 20CM).",TRAMITE USUAL,4.980000000000000426325641456060111522674560546875,0,0,0,0,0
28,209019503,APÓSITO HIDROCOLOIDE (FINO O EXTRA DELGADO)             (SE SOLICITA CUADRADO 10CM X 10CM),TRAMITE USUAL,1.649999999999999911182158029987476766109466552734375,18860,700,10,19570,32290.5
29,209019504,"APÓSITO HIDROCOLOIDE (Estándar, Regular o Extra Absorbente).  SE SOLICITA,  CUADRADO 15CM X 15CM",TRAMITE USUAL,3.79999999999999982236431605997495353221893310546875,6510,100,0,6610,25118
30,209019507,APOSITO TRANSPARENTE ESTERIL. SE SOLICITA  CON VENTANA DE 8-10CM X 10-12.5CM,TRAMITE USUAL,0.190000000000000002220446049250313080847263336181640625,0,5250,0,5250,997.5
31,209019508,APOSITO TRANSPARENTE ESTERIL. SE SOLICITA CON VENTANA TAMAÑO DE 5-6CM X 7-8CM,TRAMITE USUAL,0.1000000000000000055511151231257827021181583404541015625,0,0,0,0,0
32,209019600,APOSITO OCULAR ADULTO ESTERIL,TRAMITE USUAL,0.070000000000000006661338147750939242541790008544921875,0,12900,0,12900,903.0000000000001136868377216160297393798828125
33,209019900,INSTRUMENTO DE ENGRAPADO PARA CIERRE DE PIEL DESECHABLE ,TRAMITE USUAL,7.21999999999999975131004248396493494510650634765625,0,0,0,0,0
34,209019902,"INSTRUMENTAL DE ENGRAPADO TORACO ABDOMINAL Y REGARGA, DESECHABLE (Se solicita carga de 60mm, 3.5mm de altura de grapa abierta y 1.5mm de altura de grapa cerrada. Y por cada dos (2) instrumentos con carga, debe entregar una recarga adicional) ",TRAMITE USUAL,124.1400000000000005684341886080801486968994140625,264,0,0,264,32772.9599999999991268850862979888916015625
35,209019903,"INSTRUMENTO DE ENGRAPADO TORACO ABDOMINAL Y RECARGA DESECHABLE (Se solicita carga de 30mm, 3.5mm de altura de grapa abierta y 1.5mm de altura de grapa cerrada. Por cada dos (2) instrumentos con carga, debe entregar una recarga adicional) ",TRAMITE USUAL,123.7000000000000028421709430404007434844970703125,0,0,0,0,0
36,209019904,"INSTRUMENTO DE ENGRAPADO Y CORTE LINEAL PARA CIRUGÍA ABIERTA, DESECHABLE ",TRAMITE USUAL,120.5400000000000062527760746888816356658935546875,0,0,0,0,0
37,209019905,"INSTRUMENTAL DE ENGRAPADO TORACO ABDOMINAL Y RECARGA DESECHABLE (Se solicita instrumento recto, carga de longitud  de 90mm, altura de grapa abierta 3.5mm y altura de grapa cerrada 1.5mm. Por cada dos (2) instrumentos con carga, debe entregar una carga adicional) ",TRAMITE USUAL,187.849999999999994315658113919198513031005859375,15,0,0,15,2817.75
38,209019906,"INSTRUMENTO DE ENGRAPADO MECANICO CIRCULAR,DESECHABLE.   SE SOLICITA INSTRUMENTO CURVO CON GRAPA DE 29MM CON GRAPAS DE ALTURA MINIMA DE 4.8 MM ABIERTA O INDICADOR DE ESCALA DE COMPRENSION DE 2 MM CERRADA",TRAMITE USUAL,400,0,0,0,0,0
39,209019907,"ENGRAPADORA  CIRCULAR CORTANTE CON YUNQUE ARTICULABLE PARA ANASTOMOSIS DIGESTIVA (Se solicita de 31mm, con grapas de altura mínima de 4.8mm abierta)",TRAMITE USUAL,425.44999999999998863131622783839702606201171875,0,0,0,0,0
40,209019910,"INSTRUMENTO DE ENGRAPADO MECÁNICO PARA FIJAR  MALLAS EN  HERNIAS, DESECHABLE, CON 10 GRAPAS O MAS, DE TITANIUM  DE 4.8mm (Por cada instrumento con su carga, debe entregar una carga adicional) ",TRAMITE USUAL,123.8550000000000039790393202565610408782958984375,0,0,0,0,0
41,209020000,"INSTRUMENTO DE ENGRAPADO Y CORTE LINEAL RECTA ENDOSCOPICA CON O SIN
REGARGA,DESECHABLE     (SE SOLICITA Estándar: vástago de 16cm o longitud total de 34cm, LONGITUD DE 60MM DE LARGO, ALTURA DE GRAPA ABIERTA 3.5 Y CERRADA 1.5MM)                                                                                                                                                                                                                                                                                                                                                                                         Instrumento de engrapado de corte lineal de 12mm de diámetro.
",TRAMITE USUAL,200,0,20,0,20,4000
42,209020002,"INSTRUMENTO DE ENGRAPADO Y CORTE LINEAL RECTA ENDOSCOPICA CON O SIN REGARGA,DESECHABLE (SE SOLICITA Estándar: vástago de 16cm o longitud total de 34cm, LONGITUD DE 60MM DE LARGO, ALTURA DE GRAPA ABIERTA 2.5 Y CERRADA 1.0MM)                                                                                                                                                                                                                                                                                                                                                                                        ",TRAMITE USUAL,235.05500000000000682121026329696178436279296875,0,0,0,0,0
43,209020600,"INSTRUMENTO PARA LIGAR VASOS, DE TITANIUM, DESECHABLE (Se solicita tamaño chico)",TRAMITE USUAL,57.64500000000000312638803734444081783294677734375,0,0,0,0,0
44,209020700,"ENGRAPADORA CURVA CORTANTE PARA TEJIDO GRUESO (CIRUGIA COLON RECTAL). Instrumento de engrapado quirúrgico curvo cortante , que permita un mejor acceso y visualizacion en la pelvis baja, dos dobles linea de grapas  y corte entre la segunda y tercera linea de grapas para cirugía colon rectal.",TRAMITE USUAL,1220.180000000000063664629124104976654052734375,40,0,0,40,48807.2000000000043655745685100555419921875
45,209020902,RECARGA DE CLIP DE POLÍMERO NO ABSORBIBLE    (SE SOLICITA DE 7MM X 16MM. LA EMPRESA ENTREGARÁ A LA UNIDAD LA PINZA PARA APLICAR EL MISMO),TRAMITE USUAL,99.3900000000000005684341886080801486968994140625,0,0,0,0,0
46,209021204,"BANDEJA PRE OPERATORIA PARA LAVADO DE PIEL. SE SOLICITA CON TENAZA Y DOS APLICADORES DE 3 PULGADAS CON PUNTA DE ALGODÓN
",TRAMITE USUAL,4.3849999999999997868371792719699442386627197265625,80,0,0,80,350.799999999999954525264911353588104248046875
47,209021205,"BANDEJA DE ANESTESIA RAQUIDEA DESEHABLE CON MEDICAMENTO SE SOLICITA (CON INTRODUCTOR, AGUJA PUNTA DE LAPIZ/SPROTE 25G LARGO 136MM CON AGUJA 22G x 1 1/2"", Epinefrina 1:1000, ampolla de 1ml y efedrina sulfato 50mg/ml, ampolla de 1ml, y CON BUPIVACAINA PESADA).",TRAMITE USUAL,34,0,0,0,0,0
48,209021504,"BOLSA MIXTA TERMOSELLABLE PARA ESTERILIZAR, 12"" X 16"" A 18""(304.8 mm  X  406.4 mm a 457.2 mm)",TRAMITE USUAL,0.11500000000000000499600361081320443190634250640869140625,0,0,0,0,0
49,209021506,"BOLSA MIXTA TERMOSELLABLE PARA ESTERILIZACION 18""  X  24"" (450  X  600MM)",TRAMITE USUAL,0.25,0,0,0,0,0
50,209021507,"ROLLO SIN FUELLE TERMOSELLABLE PARA ESTERILIZACIÓN, DE 3"" DE ANCHO X 660 PIES (7.5CM Ó 75MM X 200 Mts)",TRAMITE USUAL,12.300000000000000710542735760100185871124267578125,565,0,0,565,6949.5
51,209021508,"ROLLO SIN FUELLE TERMOSELLABLE PARA ESTERILIZACION 4"" DE ANCHO x 660' (10cm Ó 100mm x 200mts)",TRAMITE USUAL,14.535000000000000142108547152020037174224853515625,0,0,0,0,0
52,209021510,"BOLSA MIXTA TERMOSELLABLE PARA ESTERILIZAR, 3""  X  10"" a  10  1/2"" (75  X  255 a 265MM)",TRAMITE USUAL,0.0350000000000000033306690738754696212708950042724609375,0,0,0,0,0
53,209021515,"BOLSA MIXTA TERMOSELLABLE PARA ESTERILIZAR 5 1/4"" A 5 1/2´´ X 10 1/2"" A 11´´ (130MM A 140MM X 260MM A 280MM) ",TRAMITE USUAL,0.05000000000000000277555756156289135105907917022705078125,0,0,0,0,0
54,209021516,"BOLSA MIXTA TERMOSELLABLE PARA ESTERILIZAR, 8""  X  12""  (200  X  300MM)",TRAMITE USUAL,0.070050000000000001154631945610162802040576934814453125,0,0,0,0,0
55,209021600,"BOLSA HIDROSOLUBLE SE SOLICITA TAMAÑO 28"" X 39""",TRAMITE USUAL,0.7800000000000000266453525910037569701671600341796875,0,0,0,0,0
56,209021701,"BOLSA DE 1 PIEZA PARA COLOSTOMIA / ILEOSTOMIA RECORTABLE, ABIERTA, PARA ADULTO .  (SE SOLICITA CON FILTRO DE CARBON INCORPORADO Y DIAMETRO DE 10mm o 12mm hasta 55mm)",TRAMITE USUAL,2.62999999999999989341858963598497211933135986328125,526720,9360,0,536080,1409890.3999999999068677425384521484375
57,209021702,"BOLSA DE 1 PIEZA PARA COLOSTOMIA / ILEOSTOMIA RECORTABLE, ABIERTA, PARA ADULTO . (SE SOLICITA CON FILTRO DE CARBON INCORPORADO Y DIAMETRO DE 10mm o 12mm hasta 70mm)",TRAMITE USUAL,3.029999999999999804600747665972448885440826416015625,411600,6720,0,418320,1267509.59999999986030161380767822265625
58,209021807,"BOLSA DE 1 PIEZA PARA COLOSTOMIA / ILEOSTOMIA PEDIATRICA, ABIERTA (RECORTABLE).  (SE SOLICITA DE 10MM A  35MM)",TRAMITE USUAL,3.70999999999999996447286321199499070644378662109375,0,1500,0,1500,5565
59,209021908,SISTEMA DE DOS PIEZAS PARA UROSTOMÌA DE ADULTO CON DIÀMETRO EXTERNO DE 50MM. OPACA (POR CADA DOS BOLSAS SE DEBERA ENTREGAR UN ARO),TRAMITE USUAL,6.62999999999999989341858963598497211933135986328125,11600,400,400,12400,82212
60,209022100,"BOLSA COLECTORA DE ORINA PARA ADULTO.
",TRAMITE USUAL,1.399999999999999911182158029987476766109466552734375,39,7945,0,7984,11177.5999999999985448084771633148193359375
61,209022300,BOLSA COLECTORA DE ORINA DE 30 A 35 ONZA DE CAPACIDAD     (900CC A 1050CC) DE PIERNA . ,TRAMITE USUAL,0.5500000000000000444089209850062616169452667236328125,0,172,0,172,94.6000000000000085265128291212022304534912109375
62,209022305,BOLSA BIODEGRADABLE COLECTORA DE VOMITO.,TRAMITE USUAL,1.5,0,0,0,0,0
63,209024800,CUBIERTA DE ZAPATO (Se solicita sin cinta),TRAMITE USUAL,0.055000000000000000277555756156289135105907917022705078125,0,0,0,0,0
64,209025901,BRAZALETE DE IDENTIFICACIÓN PEDIATRICA. SE SOLICITA: 8 PULGADAS DE LONGITUD,TRAMITE USUAL,0.036499999999999997724042799518429092131555080413818359375,844000,19000,4800,867800,31674.699999999997089616954326629638671875
65,209026003,BRAZALETE DE IDENTIFICACIÓN PARA ADULTOS.                (SE SOLICITA: 12 PULGADAS DE LONGITUD),TRAMITE USUAL,0.036999999999999998168132009368491708301007747650146484375,2874400,0,1400,2875800,106404.599999999991268850862979888916015625
66,209026600,"CALCETA TUBULAR. SE SOLICITA TAMAÑO :  3 "" X 25 YARDAS DE ALGODON",TRAMITE USUAL,8.3300000000000000710542735760100185871124267578125,0,120,0,120,999.6000000000000227373675443232059478759765625
67,209026601,"MEDIA ANTIDESLIZANTE. SE SOLICITA MEDIANA (LONGITUD: 35cms, ANCHO 8.5cm)",TRAMITE USUAL,0.97599999999999997868371792719699442386627197265625,61200,780,200,62180,60687.6800000000002910383045673370361328125
68,209026602,"MEDIA ANTIDESLIZANTE (SE SOLICITA GRANDE (Longitud: 40cms, ancho 9cm).",TRAMITE USUAL,0.9939999999999999946709294817992486059665679931640625,335592,0,200,335792,333777.248000000021420419216156005859375
69,209026700," CALCETA TUBULAR. SE SOLICITA TAMAÑO: 4 "" X 25 YARDAS.  DE ALGODON",TRAMITE USUAL,25,0,48,10,58,1450
70,209027200,"CANULA INTRAVENOSA SIN JERINGUILLA SE SOLICITA DE 18G  X  1  1/4""  A  1  1/2"" DE  POLIURETANO
",TRAMITE USUAL,0.174999999999999988897769753748434595763683319091796875,0,0,0,0,0
71,209027401,"CANULA INTRAVENOSA SIN JERINGUILLA SE SOLICITA DE POLIURETANO  CALIBRE # 22 G X  DE 1"" A  1  1/4"" .
",TRAMITE USUAL,0.270000000000000017763568394002504646778106689453125,200,0,0,200,54
72,209027402,"CÁNULA INTRAVENOSA SIN JERINGUILLA  (SE SOLICITA DE POLIURETANO, CALIBRE # 24)",TRAMITE USUAL,0.180049999999999987831955650108284316956996917724609375,0,0,0,0,0
73,209027618,"CATETER DE HISTEROSONOGRAFIA, 5Fr O 7FR. SE SOLICITA TAMAÑO  5FR Y BALON DE 3CC",TRAMITE USUAL,18.120000000000000994759830064140260219573974609375,440,70,0,510,9241.20000000000072759576141834259033203125
74,209028310,LIMPIEZA DE SUBCLAVIA CON CLOREXIDINA Y ALCOHOL .    (SE SOLICITA CON UN (1) APLICADOR),TRAMITE USUAL,3.890000000000000124344978758017532527446746826171875,0,0,0,0,0
75,209028600,"SONDA FOLEY DE LATEX RECUBIERTA CON SILICON, 2 VIAS CON BALON DE 3CC/ML   SE SOLICITA CALIBRE 10FR",TRAMITE USUAL,0.64000000000000001332267629550187848508358001708984375,190,0,0,190,121.6000000000000085265128291212022304534912109375
76,209028700,"SONDA FOLEY DE LATEX RECUBIERTA CON SILICON , 2 VÍAS CON BALÓN DE 5 CC/ML. SE  SOLICITA  CALIBRE 12FR",TRAMITE USUAL,0.52900000000000002575717417130363173782825469970703125,0,0,0,0,0
77,209028701,"SONDA FOLEY DE LATEX RECUBIERTA CON SILICON , 2 VÍAS CON BALÓN DE 5 CC/ML.   SE SOLICITA  CALIBRE 18FR",TRAMITE USUAL,0.5100000000000000088817841970012523233890533447265625,0,0,0,0,0
78,209028702,"SONDA FOLEY DE LATEX RECUBIERTA CON SILICON , 2 VÍAS CON BALÓN DE 5 CC/ML.  (SE SOLICITA CALIBRE 20FR)",TRAMITE USUAL,0.4899999999999999911182158029987476766109466552734375,5100,420,0,5520,2704.79999999999972715158946812152862548828125
79,209028703,"SONDA FOLEY DE LATEX RECUBIERTA CON SILICON , 2 VÍAS CON BALÓN DE 5 CC/ML.     SE SOLICITA CALIBRE  22FR ",TRAMITE USUAL,0.4899999999999999911182158029987476766109466552734375,0,390,0,390,191.099999999999994315658113919198513031005859375
80,209028800,"SONDA FOLEY DE LATEX RECUBIERTA CON SILICON , 2 VÍAS CON BALÓN DE 5 CC/ML.     SE SOLICITA CALIBRE 14FR",TRAMITE USUAL,0.440000000000000002220446049250313080847263336181640625,0,0,0,0,0
81,209028801,"SONDA FOLEY DE LATEX RECUBIERTA CON SILICON , 2 VÍAS CON BALÓN DE 5 CC/ML.  SE  SOLICITA  CALIBRE 16FR",TRAMITE USUAL,0.560000000000000053290705182007513940334320068359375,0,0,0,0,0
82,209029810,"SONDA FOLEY DE LATEX RECUBIERTA CON SILICÒN, 3 VÌAS CON BALÒN DE 30 CC.  SE SOLICITA CALIBRE 24FR",TRAMITE USUAL,0.89000000000000001332267629550187848508358001708984375,0,0,230,230,204.700000000000017053025658242404460906982421875
83,209029912,"TROCAR PARA CIRUGIA LAPAROSCOPICA DE 2MM A 15MM DE DIAMETRO, PUNTA CORTANTE DESECHABLESE.  (SE  SOLICITA TROCAR COMPLETO DE 5MM DE DIAMETRO Y DOS CAMISAS ADICIONALES)",TRAMITE USUAL,78.9599999999999937472239253111183643341064453125,0,0,0,0,0
84,209029914,"TROCAR PARA CIRUGIA LAPAROSCOPICA, DE 2 A 15 MM DE DIAMETRO, PUNTA CORTANTE, DESECHABLE.,                                                                                                          (SE SOLICITA TROCAR COMPLETO DE 12MM DE DIAMETRO Y DOS CAMISAS ADICIONALES) ",TRAMITE USUAL,71.0799999999999982946974341757595539093017578125,0,0,0,0,0
85,209030001,JUEGO PARA ACCESO VENOSO PERIFÉRICO (CANALIZACIÓN),TRAMITE USUAL,0.79000000000000003552713678800500929355621337890625,0,0,0,0,0
86,209030702,CERA DE HUESO. SE SOLICITA EN BASTÓN,TRAMITE USUAL,2.4900000000000002131628207280300557613372802734375,0,0,0,0,0
87,209030904,CINTA DE HILADILLO ESTERIL DE ALGODÓN TRENZADO,TRAMITE USUAL,2.904999999999999804600747665972448885440826416015625,0,0,0,0,0
88,209031000,"CINTA INDICADORA PARA ESTERILIZACION A VAPOR.  SE SOLICITA TAMAÑO  DE  1/2"" X 60 O MAS YARDAS.",TRAMITE USUAL,5.27874999999999960920149533194489777088165283203125,1204,138,0,1342,7084.0824999999995270627550780773162841796875
89,209031001,"CINTA INDICADORA PARA ESTERILIZACION A VAPOR. SE SOLICITATAMAÑO 3/4"" X 60 Ó MAS YARDAS.",TRAMITE USUAL,4.625,0,0,0,0,0
90,209031002,"CINTA INDICADORA PARA ESTERILIZACION A VAPOR                SE SOLICITA TAMAÑO  1"" X 60 O MAS YARDAS.",TRAMITE USUAL,2.797000000000000152766688188421539962291717529296875,0,0,0,0,0
91,209031100,COBERTOR PARA SILLETA (PALETA),TRAMITE USUAL,0.40000000000000002220446049250313080847263336181640625,14000,0,0,14000,5600
92,209032201,PROTECTOR PLÁSTICO PARA EL OJO,TRAMITE USUAL,8.675000000000000710542735760100185871124267578125,0,936,1536,2472,21444.60000000000218278728425502777099609375
93,209032301,"LAPIZ DE CAUTERIO, DESECHABLE CON CONTROL MANUAL DUAL.",TRAMITE USUAL,4.3582499999999999573674358543939888477325439453125,0,0,0,0,0
94,209032601,GEL PARA ELECTRODOS. SE SOLICITA TUBO DE 140 GRAMOS,TRAMITE USUAL,76.900000000000005684341886080801486968994140625,0,0,0,0,0
95,209032700,"PROTECTOR DE COLCHÓN, DESECHABLE, ABSORBENTE, DE ALGODON O DE POLIETILENO POR UN LADO, (SE SOLICITA TAMAÑO 58.4 cm x 91.4 cm  (23""x36"")  ALGODÓN.",TRAMITE USUAL,2.87999999999999989341858963598497211933135986328125,0,0,0,0,0
96,209033101,VENDA AUTOADHERIBLE DE PLASTICO RECTANGULAR O LARGAS.        (CURITAS RECTANGULAR),TRAMITE USUAL,0.00948000000000000057898130734201913583092391490936279296875,934400,10000,11900,956300,9065.724000000000160071067512035369873046875
97,209033200,VENDA ADHESIVA DE PLÁSTICO REDONDA,TRAMITE USUAL,0.01425000000000000051347814888913489994592964649200439453125,0,0,0,0,0
98,209033201,GRAPA PARA LIGAR CORDON UMBILICAL,TRAMITE USUAL,0.34999999999999997779553950749686919152736663818359375,0,0,0,0,0
99,209033306,"BATA DESECHABLE, PARA USO GENERAL NO ESTERIL .AAMI     NIVEL 3.  SE SOLICITA TAMAÑO MEDIANO",TRAMITE USUAL,1.12000000000000010658141036401502788066864013671875,0,0,0,0,0
100,209033311,BATA QUIRURGICA ESTERIL .AAMI NIVEL 3. SE SOLICITA TAMAÑO MEDIANO,TRAMITE USUAL,1.12000000000000010658141036401502788066864013671875,0,0,0,0,0
101,209033312,BATA QUIRURGICA ESTERIL .AAMI NIVEL 3. SE SOLICITA TAMAÑO GRANDE,TRAMITE USUAL,22.839999999999999857891452847979962825775146484375,0,0,0,0,0
102,209033314,BATA QUIRURGICA ESTERIL .AAMI NIVEL 4. SE SOLICITA TAMAÑO MEDIANO,TRAMITE USUAL,2.595000000000000195399252334027551114559173583984375,0,0,0,0,0
103,209033315,BATA QUIRURGICA ESTERIL .AAMI NIVEL 4.    (SE SOLICITA TAMAÑO GRANDE).,TRAMITE USUAL,2.274999999999999911182158029987476766109466552734375,0,0,0,0,0
104,209033316,BATA QUIRURGICA ESTERIL .AAMI NIVEL 4.  SE SOLICITA TAMAÑO EXTRA GRANDE,TRAMITE USUAL,0.192000000000000003996802888650563545525074005126953125,0,0,0,0,0
105,209033400,"DEPRESOR DE LENGUA, ESTÉRIL  ",TRAMITE USUAL,0.04499999999999999833466546306226518936455249786376953125,0,0,0,0,0
106,209033600,DISECTOR CURVO    (MARYLAND)      PARA CIRUGIA LAPAROSCÓPICA.,TRAMITE USUAL,59.3299999999999982946974341757595539093017578125,4,0,0,4,237.31999999999999317878973670303821563720703125
107,209034201,"CONECTOR LIBRE DE AGUJA (ESPIGA UNIVERSAL) PARA SOLUCIONES PARENTERALES, UNIDIRECCIONAL O BIDIRECCIONAL.                                                                                     SE SOLICITA: CON VÁLVULA ANTIRREFLUJO UNIDIRECCIONAL",TRAMITE USUAL,2.20999999999999996447286321199499070644378662109375,29700,3500,1700,34900,77129
108,209034510,ELECTRODO DE MICROPORE PARA MONITOREO DE ADULTO                                                                                                    ,TRAMITE USUAL,0.14000000000000001332267629550187848508358001708984375,0,0,0,0,0
109,209034512,ELECTRODO PARA  EKG MODELO PESTAÑA. SE SOLICITA: TAMAÑO NIÑO (PEDIATRICO),TRAMITE USUAL,0.1000000000000000055511151231257827021181583404541015625,0,0,0,0,0
110,209034700,"APOSITO ABDOMINAL 8"" X 10"" y 10"" x 12"" DE LONGITUD.  SE SOLICITA TAMAÑO: 8"" X 10"" DE LONGITUD. ",TRAMITE USUAL,0.479999999999999982236431605997495353221893310546875,0,0,0,0,0
111,209034901,"ESPONJA DESECHABLE CON JABON NEUTRO. SE SOLICITA: TAMAÑO 20CM X 10CM X 1.0CM    
",TRAMITE USUAL,0.40000000000000002220446049250313080847263336181640625,0,0,0,0,0
112,209035001,"TOALLA SANITARIA MATERNAL; TOALLA SANITARIA TIPO PERINEAL,     (SE SOLICITA EXTRA GRANDE DE 11 A 12 PULGADAS. NO ESTERIL)",TRAMITE USUAL,0.11000000000000000055511151231257827021181583404541015625,0,0,0,0,0
113,209035201,"CINTA ADHESIVA DE TELA DE ALGODON (ESPARADRAPO).  SE SOLICITA TAMAÑO DE 2"" X 10 Yds",TRAMITE USUAL,2.888999999999999790389892950770445168018341064453125,5760,1500,1800,9060,26174.33999999999650754034519195556640625
114,209035202,"CINTA ADHESIVA DE TELA DE ALGODON (ESPARADRAPO)  (SE SOLICITA TAMAÑO DE 3"" X 10 Yds).",TRAMITE USUAL,6.769999999999999573674358543939888477325439453125,0,0,0,0,0
115,209035203,"CINTA  ADHESIVA DE PLASTICO TRANSPARENTE. SE SOLICITA DE 1"" X 10 YARDAS                                                                                                                                                                                                                                 CINTA ADHESIVA DE PLASTICO TRANSPARENTE, HIPOALERGENICO, RESISTENTE A LA HUMEDAD (IMPERMEABLE),
TAMAÑO DE 1/2´´ A 3´´POR 10 YARDA O MAS DE LONGITUD.
LA INSTITUCION SOLICITARA EL TAMAÑO QUE REQUIERA.",TRAMITE USUAL,1.1149999999999999911182158029987476766109466552734375,0,0,0,0,0
116,209035300,CINTA ADHESIVA DE TELA DE ALGODON (ESPARADRAPO) DE CORTE SURTIDO,TRAMITE USUAL,16.379999999999999005240169935859739780426025390625,0,0,0,0,0
117,209035400,"CINTA ADHESIVA DE PAPEL MICROPOROSO. (SE SOLICITA DE 2"" DE ANCHO X 10 YARDAS DE LONGITUD).                                                                                                                                                                                                                                  
",TRAMITE USUAL,1.9499999999999999555910790149937383830547332763671875,0,0,0,0,0
118,209035401,"CINTA ADHESIVA DE PAPEL MICROPOROSO. (SE SOLICITA DE 3"" X 10 Yads)                                                                                                                                                                                                                                                                      ",TRAMITE USUAL,1.9499999999999999555910790149937383830547332763671875,30732,660,0,31392,61214.4000000000014551915228366851806640625
119,209036301,"CONECTOR O EQUIPO PARA INFUSIÓN DE SOLUCIÓN PARENTERAL, CON DOS FILTRO .",TRAMITE USUAL,0.1700000000000000122124532708767219446599483489990234375,7632148,25000,0,7657148,1301715.1600000001490116119384765625
120,209036501,"GASA SIMPLE  TAMAÑO 3"" X 3"",12 DOBLECES NO ESTERIL.",TRAMITE USUAL,0.059999999999999997779553950749686919152736663818359375,0,0,0,0,0
121,209036503,"GASA SIMPLE 4"" X 4"" CON 16 DOBLECES, NO ESTERIL.",TRAMITE USUAL,0.04499999999999999833466546306226518936455249786376953125,0,0,0,0,0
122,209036505,"GASA SIMPLE 8"" X 4"" CON 12 DOBLECES, NO ESTÉRIL.   ",TRAMITE USUAL,0.070000000000000006661338147750939242541790008544921875,558000,0,192000,750000,52500.0000000000072759576141834259033203125
123,209037800,"GUANTES DE EXPLORACIÓN DE LÁTEX, NO ESTÉRIL (SE SOLICITA TAMAÑO CHICO).",TRAMITE USUAL,0.041000000000000001720845688168992637656629085540771484375,0,0,0,0,0
124,209037801,"GUANTES DE EXPLORACIÓN DE LÁTEX, NO ESTÉRIL (SE SOLICITA TAMAÑO MEDIANO). ",TRAMITE USUAL,0.08500000000000000610622663543836097232997417449951171875,0,0,0,0,0
125,209037802,"GUANTES DE EXPLORACIÓN DE LÁTEX, NO ESTÉRIL (Se solicita tamaño grande) ",TRAMITE USUAL,0.0899999999999999966693309261245303787291049957275390625,0,0,0,0,0
126,209037900,"GUANTE QUIRURGICO DE LATEX ESTERIL.  SE SOLICITA TAMAÑO 6  1/2""  ",TRAMITE USUAL,0.23499999999999998667732370449812151491641998291015625,0,0,0,0,0
127,209037901,"GUANTES QUIRURGICO DE LATEX ESTERI (SE SOLICITA TAMAÑO 7 "").",TRAMITE USUAL,0.270000000000000017763568394002504646778106689453125,0,0,0,0,0
128,209037902,"GUANTES QUIRURGICO DE LATEX ESTERIL   (SE SOLICITA TAMAÑO 7 1/2"")",TRAMITE USUAL,0.2300000000000000099920072216264088638126850128173828125,0,0,0,0,0
129,209037903,"GUANTES QUIRURGICO DE LATEX ESTERIL  (SE SOLICITA TAMAÑO 8"").",TRAMITE USUAL,1.024999999999999911182158029987476766109466552734375,0,0,0,0,0
130,209038100,"ALGODON COMPRIMIDO 100% (SE SOLICITA  3"" x 4 YARDAS)
",TRAMITE USUAL,0.729999999999999982236431605997495353221893310546875,0,0,0,0,0
131,209038101,"VENDAJE DE 100% DE ALGODÓN COMPRIMIDO, NO ESTÉRIL (Se solicita tamaño 4""x 4 yardas) ",TRAMITE USUAL,0.56999999999999995115018691649311222136020660400390625,0,0,0,0,0
132,209038102,"ALGODON COMPRIMIDO 100% - 6"" x 4 YARDAS  (SE SOLICITA TAMAÑO 6 x 4"")",TRAMITE USUAL,0.4899999999999999911182158029987476766109466552734375,0,0,0,0,0
133,209038200,"HOJA, BISTURÍ, ACERO INOXIDABLE Nº10",TRAMITE USUAL,0.284999999999999975575093458246556110680103302001953125,0,0,0,0,0
134,209038201,HOJA DE BISTURÍ  DE ACERO INOXIDABLE (SE SOLICITA TAMAÑO N° 11),TRAMITE USUAL,1.0349999999999999200639422269887290894985198974609375,0,0,0,0,0
135,209038203,HOJA DE BISTURÍ  DE ACERO INOXIDABLE (SE SOLICITA TAMAÑO N° 15),TRAMITE USUAL,1.0349999999999999200639422269887290894985198974609375,0,0,0,0,0
136,209038204,HOJA DE BISTURÍ  DE ACERO INOXIDABLE (SE SOLICITA TANAÑO N° 23) ,TRAMITE USUAL,1.0749999999999999555910790149937383830547332763671875,0,0,0,0,0
137,209038206,CUCHILLETE ESPATULADO ESTILO CRESCENT ,TRAMITE USUAL,15,60,0,60,120,1800
138,209038207,CUCHILLA PARA FACOEMULSIFICACIÓN (Se solicita de 2.65mm),TRAMITE USUAL,15.2249999999999996447286321199499070644378662109375,180,0,0,180,2740.5
139,209038208,CUCHILLA PARA FACOEMULSIFICACIÓN.  (SE SOLICITA TAMAÑO  3.2MM),TRAMITE USUAL,10.5,0,0,0,0,0
140,209039500,JERINGUILLA 2 ONZ. ( 60ML),TRAMITE USUAL,0.8000000000000000444089209850062616169452667236328125,0,0,0,0,0
141,209039800,JERINGUILLA DE 2-3 ML DE CAPACIDAD CON AGUJA DE 21 G X 1½ PULGADAS.,TRAMITE USUAL,0.1000000000000000055511151231257827021181583404541015625,0,0,0,0,0
142,209039900,"JERINGUILLA DE 5 -6 ML,     (SE SOLICITA CON AGUJA 21 G X 1½ PULGADAS)",TRAMITE USUAL,0.0350000000000000033306690738754696212708950042724609375,0,0,0,0,0
143,209040100,AGUJA METALICA CON PISTOLA AUTOMATICA PARA TOMA DE BIOPSIA.  (SE SOLICITA EL TAMAÑO 18G  X 10 A 25CM.),TRAMITE USUAL,31.89999999999999857891452847979962825775146484375,0,0,0,0,0
144,209040200,"JERINGUILLA DE 10 -12 ML, CON AGUJA DE 21 G X 1½ PULGADAS.",TRAMITE USUAL,0.03225999999999999701127961770907859317958354949951171875,0,0,0,0,0
145,209040500,"CANULA PARA IRRIGACION, CAUTERIO Y SUCCION ENDOSCOPICA DE GANCHO DE 5MM.",TRAMITE USUAL,100,0,0,0,0,0
146,209040600,SISTEMA CERRADO PARA DRENAJE DE FLUIDOS CONTINUOS REDONDO.  SE SOLICITA DE 10mm CON RESERVORIO DE 100CC,TRAMITE USUAL,16.809999999999998721023075631819665431976318359375,0,0,0,0,0
147,209040601,SISTEMA CERRADO PARA DRENAJE DE FLUIDOS CONTINUOS REDONDO. (SE SOLICITARA DE 7mm CON RESERVORIO DE 100CC),TRAMITE USUAL,17.1700000000000017053025658242404460906982421875,0,0,0,0,0
148,209040900,"JERINGUILLA 20-25 ML,       (SE SOLICITA PUNTA DE ROSCA SIN AGUJA)",TRAMITE USUAL,0.04427999999999999991562305012848810292780399322509765625,1576600,114400,109500,1800500,79726.139999999999417923390865325927734375
149,209041200,"JERINGUILLA 50-60ML. SE SOLICITA  50ml, PUNTA ROSCA S/AGUJA",TRAMITE USUAL,0.2049999999999999877875467291232780553400516510009765625,531200,0,2000,533200,109306
150,209041900,"JERINGUILLA DE TUBERCULINA CON AGUJA 25 G X 5/8"".",TRAMITE USUAL,3.45000000000000017763568394002504646778106689453125,0,0,0,0,0
151,209041901,"JERINGUILLA DE TUBERCULINA     (SE SOLICITA CON AGUJA 26 G X 3/8"")",TRAMITE USUAL,0.0307000000000000015931700403370996355079114437103271484375,6213600,43100,5800,6262500,192258.75
152,209042805,ROPA DESECHABLE PARA CIRUGIA ARTROSCOPICA,TRAMITE USUAL,30.67999999999999971578290569595992565155029296875,0,0,0,0,0
153,209043101,"MASCARA DE TIENDA PARA OXIGENO DE ADULTO CON TUBO CORRUGADO MÁSCARA DE TIENDA, PARA ADULTO, DESECHABLE, DE VINIL TRANSPARENTE, MUY SUAVE, MOLDEADO PARA LA BARBILLA, TUBO CORRUGADO DE 6PIES ( 72 PULGADAS ), BANDA DE ELÁSTICO PARA LA CABEZA.",TRAMITE USUAL,2,0,0,0,0,0
154,209043200,"RESPIRADORES CONTRA PARTICULAS DE ALTA FILTRACION N95 CON O SIN VALVULA DE EXALACION.        (SE SOLICITA TAMAÑO GRANDE , SIN VALVULA DE EXALACION).",TRAMITE USUAL,0.92339999999999999857891452847979962825775146484375,0,0,0,0,0
155,209044100,"LLAVE DE TRES VIAS CON DOS (2) CONECTORES,ESTÉRIL.",TRAMITE USUAL,0.375,71600,2000,2400,76000,28500
156,209044300,"MALLA PARA REFORZAR PLANOS ANATOMICOS  SE SOLICITA DE 7.5 CM X 12.5CM                                                                                                                                                                                                                                                                                                                                        Para reparación tisular convencional y laparoscópica.
Especificaciones: 
1. Estéril.
2. Polipropileno monofilamentoso no absorbible.
3. Flexible.
4. Bordes lisos redondeados.
5. Autoexpandible.
6. Tamaños:
• 7.5cm a 30.4cm (3” a 12”) x 7.5cm a 35.5cm (3” a 14”).",TRAMITE USUAL,48,180,0,0,180,8640
157,209044400,MALLA PARA REFORZAR PLANOS ANATOMICOS. SE SOLICITA TAMAÑO DE 15 CM X 15CM,TRAMITE USUAL,19.60000000000000142108547152020037174224853515625,0,0,0,0,0
158,209044401,"MALLA PARA REFORZAR PLANOS ANATOMICOS, 3"" A 10"" (7.5 A 25.4CM.) X 5"" A 14"" ( 12.5CM  A 35CM),  (SOLICITAMOS  22.9CM X 35CM.)",TRAMITE USUAL,131.5,0,0,0,0,0
159,209045000,MASCARILLA RECTANGULAR CON VISOR  (SE SOLICITA CON VISOR PARA ADULTO),TRAMITE USUAL,0.158700000000000007727152251391089521348476409912109375,401516,19000,1000,421516,66894.589200000002165324985980987548828125
160,209045100,MASCARILLA PARA OXIGENO DE MEDIA CONCENTRACION  (SE SOLICITA TAMAÑO ADULTO ALARGADA SIN RESVORIO )                                                                                                                                                                                                                                                            ,TRAMITE USUAL,1.6599999999999999200639422269887290894985198974609375,0,0,0,0,0
161,209045200,"MASCARILLA RECTANGULAR DESECHABLE CUATRO TIRAS , CON O SIN VISOR. (SE SOLICITA  SIN VISOR TAMAÑO ADULTO)",TRAMITE USUAL,0.0899999999999999966693309261245303787291049957275390625,0,0,0,0,0
162,209045301,"CONECTOR PARA ADMINISTRACION DE SOLUCION INTRAVENOSA CON BURETA (MICROGOTERO) (SE SOLICITA SITIO DE INYECCION CON MENBRANA  Y SITIO EN""Y""  LIBRE DE AGUJA) (SOLICITAMOS LIBRE DE AGUJA.)
",TRAMITE USUAL,2.305000000000000159872115546022541821002960205078125,0,0,0,0,0
163,209045304,MICRONEBULIZADOR CON MASCARA. (SE SOLICITA TAMAÑO PEDIÁTRICO),TRAMITE USUAL,0.403650000000000008792966355031239800155162811279296875,0,0,0,0,0
164,209045306,MICRONEBULIZADOR CON MASCARA. (SE SOLICITA TAMAÑO ADULTO),TRAMITE USUAL,0.414449999999999985078602549037896096706390380859375,0,0,0,0,0
165,209045502,ALGODÓN EN MOTAS (Se solicita mota de 0.7gr) ,TRAMITE USUAL,0.005000000000000000104083408558608425664715468883514404296875,463400,946000,854000,2263400,11317
166,209046111,"PAÑAL DESECHABLE PARA RECIEN NACIDO HASTA 5 LIBRAS (2.27Kg)                                                                                                                                                                                                                                                         
",TRAMITE USUAL,0.2149999999999999966693309261245303787291049957275390625,0,0,0,0,0
167,209046112,"PAÑAL DESECHABLE PARA ADULTO. SE SOLICITA TAMAÑO DE CINTURA 45"" A  58"" ( 114.3 CM A 147.32 CM)DE TELA NO TEJIDA)",TRAMITE USUAL,0.4050000000000000266453525910037569701671600341796875,0,0,0,0,0
168,209046113,PAÑAL DESECHABLE PARA NIÑO. SE SOLICITA PESO DE 6 A 14 LBS,TRAMITE USUAL,0.2200000000000000011102230246251565404236316680908203125,0,0,0,0,0
169,209046114,PAÑAL DESECHABLE PARA NIÑO. SE SOLICITA PESO DE 12 A 24 LBS.                                                                                                                                                                                                                                                      ,TRAMITE USUAL,0.304999999999999993338661852249060757458209991455078125,0,0,0,0,0
170,209046700,"PAPEL PARA ESTERILIZAR GRADO MÉDICO (MINIMO DE 60 GRAMOS POR METRO CUADRADO), SE SOLICITA DE 8"" X 8"" (20 CMS X 20 CMS).",TRAMITE USUAL,0.0297000000000000007049916206369744031690061092376708984375,0,0,0,0,0
171,209046701,"PAPEL PARA ESTERILIZAR GRADO MÉDICO (MINIMO DE 60 GRAMOS POR METRO CUADRADO) SE SOLICITA DE 12"" X  12"" (30 CMS X 30 CMS)",TRAMITE USUAL,0.055000000000000000277555756156289135105907917022705078125,0,0,0,0,0
172,209046704,"PAPEL PARA ESTERILIZAR GRADO MÉDICO (MINIMO 60 GRAMOS POR METRO CUADRADO), SE SOLICITA DE 16"" X  16"" (40 CMS X 40 CMS)",TRAMITE USUAL,0.036799999999999999378275106209912337362766265869140625,0,0,0,0,0
173,209046705,"PAPEL PARA ESTERILIZAR GRADO MÉDICO (MINIMO 60 GRAMOS POR METRO CUADRADO),  SE SOLICITA 18"" X 18"" (46 CMS. X 46 CMS.)",TRAMITE USUAL,0.08000000000000000166533453693773481063544750213623046875,0,0,0,0,0
174,209046707,"PAPEL PARA ESTERILIZAR GRADO MÉDICO (MINIMO DE 60 GRAMOS POR METRO CUADRADO), (SE SOLICITA DE 24"" X 24"" 60 CMS. X 60 CMS.)",TRAMITE USUAL,0.10499999999999999611421941381195210851728916168212890625,0,0,0,0,0
175,209046709,"PAPEL PARA ESTERILIZAR GRADO MÉDICO (MÍNIMO 60 GRAMOS POR METRO CUADRADO),  SOLICITAMOS 30"" X 30"" (75 CMS. 75 CMS).",TRAMITE USUAL,0.2200000000000000011102230246251565404236316680908203125,0,0,0,0,0
176,209047500,"PINZA DE AGARRE LAPAROSCOPICA CON DIENTE, 5MM DESECHABLE",TRAMITE USUAL,60.53999999999999914734871708787977695465087890625,400,0,0,400,24216
177,209047501,"INSTRUMENTO PARA LIGAR VASOS DE TITANIUM, DESECHABLE  (SE SOLICITA TAMAÑO GRANDE)",TRAMITE USUAL,94.5400000000000062527760746888816356658935546875,0,108,0,108,10210.320000000001527951098978519439697265625
178,209047502,"INSTRUMENTO PARA LIGAR VASOS DE TITANIUM, DESECHABLE  (SE SOLICITA TAMAÑO MEDIANO)",TRAMITE USUAL,60.8900000000000005684341886080801486968994140625,0,0,0,0,0
179,209047600,PLACA PARA IMPRESIÓN PLANTAR,TRAMITE USUAL,1.149999999999999911182158029987476766109466552734375,0,0,0,0,0
180,209048600,"SISTEMA CERRADO PARA DRENAJE DE FLUIDOS CONTINUOS. SE SOLICITA DE 19FR.,  DE SILICONA RESERVORIO 400CC A 450CC",TRAMITE USUAL,33.68999999999999772626324556767940521240234375,0,0,0,0,0
181,209048901, SISTEMA PARA ASPIRACION DE MUESTRA DE MUCOSIDADES (TRAMPA),TRAMITE USUAL,1.649999999999999911182158029987476766109466552734375,0,100,0,100,165
182,209049500,JUEGO DE BOLSA DESECHABLE PARA CADÁVER,TRAMITE USUAL,6.92999999999999971578290569595992565155029296875,13050,500,200,13750,95287.5
183,209049600,CONECTOR LIBRE DE AGUJAS PARA ACCESOS VASCULARES VENOSOS,TRAMITE USUAL,1.7399999999999999911182158029987476766109466552734375,0,0,0,0,0
184,209049700,SET DESECHABLE PARA REMOVER PUNTOS DE SUTURAS. SE SOLICITA PINZA DE METAL,TRAMITE USUAL,1.770000000000000017763568394002504646778106689453125,0,0,0,0,0
185,209049704,"SISTEMA DE CATÉTER URETERAL DOBLE J, PARA ADULTO.                    (SE SOLICITA DIAMETRO DE 6FR)",TRAMITE USUAL,132.5,0,0,0,0,0
186,209049800,"BANDEJA PARA PREPARACIÓN Y RASURADO DE LA PIEL
DESECHABLE PARA LA PREPARACION Y RASURADO DE LA PIEL, COMPUESTO POR: 1- BANDEJA PLÀSTICA CON COMPARTIMIENTOS. 2- UNA MAQUINA DE RASURAR CON SU HOJA. 3- GASA 4"" X 4"". 4- CON SOLUCION JABONOSA DE BETHADINE. 5- DOS (2) APLICADORES DE 3"" CON PUNTA DE ALGODÒN. 6- DOS (2)TOALLAS PARA LA LIMPIEZA.BANDEJA PARA PREPARACION Y RASURADO DE LA PIEL.",TRAMITE USUAL,1.2849999999999999200639422269887290894985198974609375,0,0,0,0,0
187,209049802,RECIPIENTE PARA SUCCION  SE SOLICITA Con válvulas de cierre,TRAMITE USUAL,2.734999999999999875655021241982467472553253173828125,1400,300,0,1700,4649.5
188,209049803,"RECIPIENTE PARA SUCCION      SE SOLICITA Con válvulas de cierre -Capacidad De  2000 A 3000 cc DEBE ENTREGAR LOS EQUIPOS Y CONECTORES NECESARIOS PARA SU UTILIZACION, MINIMO 300 UNIDADES O SER COMPATIBLE CON EQUIPO EN LA INSTITUCION ADJUDICACION GLOBAL CON EL RENGLON 367",TRAMITE USUAL,2.770000000000000017763568394002504646778106689453125,0,0,0,0,0
189,209050104,SISTEMA DE SUCCION E IRRIGACION LAPAROSCOPICA CON ESPATULA,TRAMITE USUAL,54.9669999999999987494447850622236728668212890625,4351,10,0,4361,239711.0869999999995343387126922607421875
190,209051000,SONDA LISA DE CAUCHO BLANDO ROJO PARA CATETERISMO URETRAL. SE SOLICITA TAMAÑO 8 FR,TRAMITE USUAL,0.396799999999999986055598810708033852279186248779296875,0,0,0,0,0
191,209051001,SONDA LISA DE CAUCHO BLANDO ROJO PARA CATETERISMO URETRAL. (SE SOLICITA TAMAÑO 10 FR),TRAMITE USUAL,0.396799999999999986055598810708033852279186248779296875,0,1000,925,1925,763.839999999999918145476840436458587646484375
192,209051002,SONDA LISA DE CAUCHO BLANDO ROJO PARA CATETERISMO URETRAL. (SE SOLICITA TAMAÑO 12 FR),TRAMITE USUAL,0.434999999999999997779553950749686919152736663818359375,0,0,0,0,0
193,209051003,SONDA LISA DE CAUCHO BLANDO ROJO PARA CATETERISMO URETRAL. (SE SOLICITA TAMAÑO 14 FR),TRAMITE USUAL,0.38719999999999998863131622783839702606201171875,0,0,0,0,0
194,209051004,SONDA LISA DE CAUCHO BLANDO ROJO PARA CATETERISMO URETRAL. SE SOLICITA  TAMAÑO 16FR,TRAMITE USUAL,0.6350000000000000088817841970012523233890533447265625,0,1830,250,2080,1320.799999999999954525264911353588104248046875
195,209051005,SONDA LISA DE CAUCHO BLANDO ROJO PARA CATETERISMO URETRAL. (SE SOLICITA TAMAÑO 18 FR),TRAMITE USUAL,0.419999999999999984456877655247808434069156646728515625,0,0,0,0,0
196,209051201,"CATETER DE SUCCION NASO-FARINGEA . SE SOLICITA, CALIBRE 8FR DE 35CM DE LONGITD, CON GRADUACION Y PRESENTACION LONGITUDINAL.
",TRAMITE USUAL,0.9899999999999999911182158029987476766109466552734375,0,0,0,0,0
197,209051300,"CATETER DE SUCCION NASO-FARINGEA . SE SOLICITA, CALIBRE 10FR DE 45CM DE LONGITD, CON GRADUACION Y PRESENTACION LONGITUDINAL.

",TRAMITE USUAL,0.71499999999999996891375531049561686813831329345703125,0,0,0,0,0
198,209051301,"CATETER DE SUCCION NASO-FARINGEA. (SE SOICITA, CALIIBRE 12FR DE 45CM DE LONGITD, CON GRADUACION Y PRESENTACION LONGITUDINAL.)",TRAMITE USUAL,0.445000000000000006661338147750939242541790008544921875,0,0,0,0,0
199,209051302,"CATETER DE SUCCION NASO-FARINGEA . SE SOLICITA, CALIBRE 14FR DE 45CM DE LONGITUD, CON GRADUACION Y PRESENTACION LONGITUDINAL.

",TRAMITE USUAL,0.58499999999999996447286321199499070644378662109375,0,0,0,0,0
200,209051303,"CATETER DE SUCCION NASO-FARINGEA. (SE SOLICITA, CALIBRE 16FR DE 45CM DE LONGITD, CON GRADUACION Y PRESENTACION LONGITUDINAL.)",TRAMITE USUAL,0.58999999999999996891375531049561686813831329345703125,0,0,0,0,0
201,209051304,"CATETER DE SUCCION NASO-FARINGEA SE SOLICITA CALIBRE 18Fr,45cm DE LONGITUD CON GRADUACION Y PRESENTACION LONGITUDINAL
",TRAMITE USUAL,0.7399999999999999911182158029987476766109466552734375,0,0,0,0,0
202,209051901,"MALLA HEMOSTATICA  (SE SOLICITA TIPO MALLA 2"" X 14"", 5CM X 35CM)                                                                                                                                                                                                                                                                                                                            ",TRAMITE USUAL,22.25,0,0,0,0,0
203,209051902,"MALLA HEMOSTATICA       SE SOLICITA  TIPO MALLA 4"" X 8"", 10CM X 20CM",TRAMITE USUAL,31.940000000000001278976924368180334568023681640625,1425,0,0,1425,45514.5
204,209051903,MALLA HEMOSTATICA (SE SOLICITA TIPO TELA DE 7.5 CM X 10.2CM DE LARGO).,TRAMITE USUAL,72.1650000000000062527760746888816356658935546875,0,0,0,0,0
205,209051906,MALLA QUIRURGICA TRIDIMENSIONAL PARA REFORZAR PLANOS ANATOMICOS  SE SOLICITA  4.5CM X 7.5CM                                                                                                                                                                                                                      ,TRAMITE USUAL,194.12101000000001249645720236003398895263671875,0,0,0,0,0
206,209051907,MALLA QUIRURGICA TRIDIMENSIONAL PARA REFORZAR PLANOS ANATOMICOS  (SE SOLICITA 4.5CMS X 10CM  (BASE DE 10CMS TAMAÑO GRANDE)                                                                                                                                                                                                                      ,TRAMITE USUAL,206.1100000000000136424205265939235687255859375,0,0,0,0,0
207,209052001,MALLA EXPANDIBLE TUBULAR            (SE SOLICITA TAMAÑO 1),TRAMITE USUAL,3.622529999999999805737616043188609182834625244140625,0,118,0,118,427.4585399999999708597897551953792572021484375
208,209052002, MALLA EXPANDIBLE TUBULAR. SE SOLICITA  TAMAÑO 2 CON CODIFICACIÓN DE COLORES. ,TRAMITE USUAL,3.12999999999999989341858963598497211933135986328125,0,0,0,0,0
209,209052004," MALLA EXPANDIBLE TUBULAR.  SE SOLICITA TAMAÑO 4, SIN CODIFICADOR DE COLORES.",TRAMITE USUAL,5.3849999999999997868371792719699442386627197265625,0,0,0,0,0
210,209052005,MALLA EXPANDIBLE TUBULAR.           (SE SOLICITA TAMAÑO 5),TRAMITE USUAL,6.88999999999999968025576890795491635799407958984375,0,0,0,0,0
211,209052006, MALLA EXPANDIBLE TUBULAR.  SE SOLICITA TAMAÑO 6,TRAMITE USUAL,6.98500000000000031974423109204508364200592041015625,0,0,0,0,0
212,209052007,MALLA EXPANDIBLE TUBULAR.  SE SOLICITA TAMAÑO 7,TRAMITE USUAL,8.6844099999999997407940099947154521942138671875,0,0,0,0,0
213,209052008,MALLA EXPANDIBLE TUBULAR.   (SE SOLICITA TAMAÑO 8 SIN CODIFICADOR DE COLORES),TRAMITE USUAL,9.280120000000000146656020660884678363800048828125,11526,334,0,11860,110062.223200000007636845111846923828125
214,209052009,MALLA EXPANDIBLE TUBULAR. SE SOLICITA TAMAÑO 9 SIN CODIFICADOR DE COLORES.,TRAMITE USUAL,16.22500000000000142108547152020037174224853515625,174,196,104,474,7690.6500000000005456968210637569427490234375
215,209052102,"FÉRULA CERVICAL PARA CUELLO DE DOS PIEZAS, TIPO PHILADELPHIA CIRCUNFERENCIA: PEQUEÑO DE 10"" A 13"". ALTURA: DE 2¼ A 3¼",TRAMITE USUAL,10.8241700000000005132960723130963742733001708984375,76,0,0,76,822.6369200000000319050741381943225860595703125
216,209052103,"FÉRULA CERVICAL PARA CUELLO DE DOS PIEZAS, TIPO PHILADELPHIA, CIRCUNFERENCIA: MEDIANO DE 13"" A 16"". ALTURA: DE 2¼ A 4¼",TRAMITE USUAL,20,0,0,0,0,0
217,209052104,"FÉRULA CERVICAL PARA CUELLO DE DOS PIEZAS, TIPO PHILADELPHIA (Se solicita circunferencia grande de  16"" a 19"", altura de 1½"" a 5¼"")                                                                                                   ",TRAMITE USUAL,14.1099999999999994315658113919198513031005859375,204,20,5,229,3231.19000000000005456968210637569427490234375
218,209052502,TAPON HEPARINIZADO PARA CANULA INTRAVENOSA. Para el cierre temporal de cánula intravenosa y administración de medicamentos a intervalos regulares.(Se Solicita con membrana de látex y con Con conexión de rosca (luer lock).,TRAMITE USUAL,0.1650000000000000077715611723760957829654216766357421875,0,0,0,0,0
219,209052801,TIJERA CURVA PARA CIRUGIA LAPAROSCÓPICA. ,TRAMITE USUAL,34.219999999999998863131622783839702606201171875,0,0,0,0,0
220,209053500,TUBO UNIVERSAL DE PLASTICO.  SE SOLICITA DE 6 MM. (1/4 DE PULGADA) DE LONGITUD DE 30 MT. (100PIES),TRAMITE USUAL,9.925000000000000710542735760100185871124267578125,0,0,0,0,0
221,209054600,"TUBO NASOGASTRICA TIPO LEVIN .SOLICITAMOS TAMAÑO 8 FR, LONG 120CM.
",TRAMITE USUAL,1.1149999999999999911182158029987476766109466552734375,0,0,0,0,0
222,209054601,"TUBO NASOGASTRICA TIPO LEVIN. SOLICITAMOS TAMAÑO 10FR, LONG 120CM
",TRAMITE USUAL,0.6149999999999999911182158029987476766109466552734375,100,300,100,500,307.5
223,209054602,"TUBO NASOGASTRICA TIPO LEVIN. SOLICITAMOS TAMAÑO 12 FR, LONG 120CM
",TRAMITE USUAL,0.97499999999999997779553950749686919152736663818359375,0,270,100,370,360.75
224,209054700,"TUBO NASOGASTRICA TIPO LEVIN. SOLICITAMOS TAMAÑO 18 FR, LONG 120CM",TRAMITE USUAL,1.0449999999999999289457264239899814128875732421875,0,0,0,0,0
225,209054800,"TUBO NASOGÁSTRICO TIPO LEVIN (Se solicita de 16 FR, longitud 120cm)  
",TRAMITE USUAL,0.95499999999999996003197111349436454474925994873046875,0,0,0,0,0
226,209055601,TUBO ENDOTRAQUEAL CON BALON            (SE SOLICITA TAMAÑO DE 7MM),TRAMITE USUAL,0.51300000000000001154631945610162802040576934814453125,47360,420,300,48080,24665.0400000000008731149137020111083984375
227,209055602,TUBO ENDOTRAQUEAL CON BALON. SE SOLICITA TAMAÑO DE 7.5MM,TRAMITE USUAL,0.51300000000000001154631945610162802040576934814453125,24560,1030,140,25730,13199.489999999999781721271574497222900390625
228,209055603,TUBO ENDOTRAQUEAL CON BALON             (SE SOLICITA TAMAÑO DE 8MM),TRAMITE USUAL,0.51300000000000001154631945610162802040576934814453125,35480,0,70,35550,18237.1500000000014551915228366851806640625
229,209055604,TUBO ENDOTRAQUEAL CON BALON.                                      (SE SOLICITA TAMAÑO DE 8.5MM),TRAMITE USUAL,0.51300000000000001154631945610162802040576934814453125,0,220,0,220,112.8599999999999994315658113919198513031005859375
230,209055901,CANÚLA DE TRAQUEOSTOMÍA. SE SOLICITA TAMAÑO N° 8,TRAMITE USUAL,46.25,0,0,52,52,2405
231,209055904,CANÚLA DE TRAQUEOSTOMÍA.                      (SE SOLICITA TAMAÑO N° 6),TRAMITE USUAL,39.99000000000000198951966012828052043914794921875,0,136,0,136,5438.6400000000003274180926382541656494140625
232,209056301,CÁNULA OROFARINGEA TIPO BERMAN (SE SOLICITA DE 90MM ADULTO).,TRAMITE USUAL,0.330000000000000015543122344752191565930843353271484375,0,0,0,0,0
233,209056302,CANULA OROFARINGEA TIPO BERMAN. SE SOLICITA N°10 (100MM) ADULTO,TRAMITE USUAL,0.52500000000000002220446049250313080847263336181640625,0,0,0,0,0
234,209056400,"SONDA O TUBO PARA ALIMENTACIÓN ENTERAL DE 5 FR A 20FR, Se solicita calibre 5FR y 38cm de longitud CON TAPON INCORPORADO
",TRAMITE USUAL,1.7199999999999999733546474089962430298328399658203125,0,0,0,0,0
235,209056500,SONDA O TUBO PARA ALIMENTACION ENTERAL DE 5 FR A 20FR.        (SE SOLICITA CALIBRE 8 FR Y 38CM DE LONGITUD),TRAMITE USUAL,0.5500000000000000444089209850062616169452667236328125,350,0,0,350,192.500000000000028421709430404007434844970703125
236,209056700,"TUBOS DE DRENAJE TIPO PENROSE. SE SOLICITA 1/4"" 6.35MM x 45.7 CM",TRAMITE USUAL,0.967999999999999971578290569595992565155029296875,0,0,0,0,0
237,209056702,"TUBO DE DRENAJE TIPO PEMROSE. SE SOLICITA DE:  1/2"" (12.70MM)  X 12"" (30.5CM)  DE LONGITUD",TRAMITE USUAL,1.5,0,0,0,0,0
238,209056800,CANULA NASAL PARA ADMINISTRAR OXIGENO (SE SOLICITA TAMAÑO ADULTO),TRAMITE USUAL,0.854999999999999982236431605997495353221893310546875,0,0,0,0,0
239,209056801,CANULA NASAL PARA ADMINISTRAR OXIGENO. SE SOLICITA: TAMAÑO PEDIATRICO,TRAMITE USUAL,0.36999999999999999555910790149937383830547332763671875,0,0,0,0,0
240,209057600,VASO PLÁSTICO DESECHABLE  PARA MEDICAMENTO (SE SOLICITA SIN TAPA),TRAMITE USUAL,0.0290000000000000014710455076283324160613119602203369140625,5000,31600,53000,89600,2598.40000000000009094947017729282379150390625
241,209057702,"VENDA ABDOMINAL QUIRÚRGICA . SE SOLICITA  TAMAÑO 18 X 18"" PULGADAS.                                                                                                                                                                                                                          
Venda abdominal de gasa prelavada, Estéril De 8¨ a 18"" x 18""a 36¨ Malla de 20 a 24 x 28 hilos, Cuatro a seis(4-6) dobleces. Con elemento radio-opaco. LA INSTITUCION SOLICITARA EL TAMAÑO REQUERIDO.",TRAMITE USUAL,0.395000000000000017763568394002504646778106689453125,0,12600,0,12600,4977
242,209057800,"VENDA AJUSTABLE DE GASA ABSORBENTE DE 1 A 2 DOBLECES (Se solicita de 1"") ",TRAMITE USUAL,0.1600000000000000033306690738754696212708950042724609375,0,0,0,0,0
243,209057801,"VENDA AJUSTABLE DE GASA ABSORBENTE DE 1 A 2 DOBLECES. SE SOLICITA TAMAÑO DE  2""",TRAMITE USUAL,0.0793999999999999983568699235547683201730251312255859375,0,0,0,0,0
244,209057802,"VENDA AJUSTABLE DE GASA ABSORBENTE DE 1 A 2 DOBLECES. SE  SOLICITA  TAMAÑO DE  3""",TRAMITE USUAL,0.1232499999999999984456877655247808434069156646728515625,0,0,0,0,0
245,209057803,"VENDA AJUSTABLE DE GASA ABSORBENTE DE 1 A 2 DOBLECES. SE  SOLICITA TAMAÑO DE  4""",TRAMITE USUAL,0.1368000000000000049293902293356950394809246063232421875,0,0,0,0,0
246,209058002,"VENDA DE GASA SIMPLE 1 A 4"" DE ANCHO                                                                                                                                                                                                              ",TRAMITE USUAL,0.24099999999999999200639422269887290894985198974609375,0,0,0,0,0
247,209058003,"VENDA DE GASA SIMPLE  (Se solicita de 4"" de ancho y 10yds de longitud). ",TRAMITE USUAL,0.59999999999999997779553950749686919152736663818359375,0,0,0,0,0
248,209058100,"VENDA ELASTICA  SE SOLICITA 2"" DE ANCHO X 5"" YARDAS DE LONGITUD                                                                                                                                                                                                                                                                            ",TRAMITE USUAL,0.645000000000000017763568394002504646778106689453125,3168,792,0,3960,2554.20000000000027284841053187847137451171875
249,209058101,"VENDA ELASTICA  SE SOLICITA 3"" DE ANCHO X 5"" YARDAS DE LONGITUD                                                                                                                                                                                                                                                                               ",TRAMITE USUAL,0.261940000000000006163958232718869112432003021240234375,0,0,0,0,0
250,209058102,"VENDA ELASTICA  SE SOLICITA 4"" DE ANCHO X 5"" YARDAS DE LONGITUD                                                                                                                                                                                                                                                                               ",TRAMITE USUAL,1.33499999999999996447286321199499070644378662109375,15864,0,0,15864,21178.43999999999869032762944698333740234375
251,209058103,"VENDA ELASTICA  SE SOLICITA 6"" DE ANCHO X 5"" YARDAS DE LONGITUD                                                                                                                                                                                                                                                                               ",TRAMITE USUAL,74,0,0,0,0,0
252,209058300,"VENDA DE YESO     (SE SOLICITA DE FRAGUADO RÁPIDO DE 3"" X 3 YARDAS, DE MAXIMO DE 5 MINUTOS)",TRAMITE USUAL,1.0800000000000000710542735760100185871124267578125,0,480,0,480,518.40000000000009094947017729282379150390625
253,209058301,"VENDA DE YESO . SE SOLICITA DE FRAGUADO RÁPIDO MAXIMO DE 5 MINUTOS DE 4"" X 3 YARDAS",TRAMITE USUAL,2.020000000000000017763568394002504646778106689453125,6148,0,0,6148,12418.960000000000945874489843845367431640625
254,209058302,"VENDA DE YESO, SE SOLICITA DE FRAGUADO RÁPIDO MAXIMO DE 5 MINUTOS DE  4"" X 5 YARDAS.",TRAMITE USUAL,2.055000000000000159872115546022541821002960205078125,0,0,0,0,0
255,209058303,"VENDA DE YESO  SE SOLICITA DE FRAGUADO RÁPIDO MAXIMO DE 5 MINUTOS DE 5"" X 5 YARDAS",TRAMITE USUAL,2.45000000000000017763568394002504646778106689453125,0,176,0,176,431.200000000000045474735088646411895751953125
256,209058304,"VENDA DE YESO, SE SOLICITA DE FRAGUADO RÁPIDO MAXIMO DE 5 MINUTOS DE 6"" X 5 YARDAS.",TRAMITE USUAL,3.529999999999999804600747665972448885440826416015625,72,384,672,1128,3981.83999999999969077180139720439910888671875
257,209058306,"VENDA DE YESO, SE SOLICITA DE FRAGUADO RÁPIDO MAXIMO DE  5 MINUTOS DE  8"" X 5 YARDAS.",TRAMITE USUAL,3.4900000000000002131628207280300557613372802734375,0,432,0,432,1507.680000000000063664629124104976654052734375
258,209058400,"VENDA DE GASA ABSORBENTE AJUSTABLE,  6 DOBLECES",TRAMITE USUAL,0.7600000000000000088817841970012523233890533447265625,0,4650,1150,5800,4408
259,209058900,"SUTURA CATGUT CRÓMICO, CALIBRE 0, LONGITUD 67 A 75 CM.  AGUJA DE 35 A 37MM, DELGADA, ½ ÍIRCULO, PUNTA REDONDA. ",TRAMITE USUAL,1.1350000000000000088817841970012523233890533447265625,28272,0,0,28272,32088.72000000000116415321826934814453125
260,209059200,"SUTURA: CATGUT CRÓMICO, CALIBRE 1",TRAMITE USUAL,1.3000000000000000444089209850062616169452667236328125,0,0,0,0,0
261,209059300,"SUTURA: CATGUT CRÓMICO, (SE SOLICITA CALIBRE 1)",TRAMITE USUAL,0.81650999999999995804245145336608402431011199951171875,0,0,0,0,0
262,209059400,"SUTURA: CATGUT CRÓMICO, CALIBRE 1, LONGITUD 75 CM,  AGUJA DE  37 MM, GRUESA, ½ CÍRCULO, PUNTA REDONDA GRUESA. ",TRAMITE USUAL,1.20999999999999996447286321199499070644378662109375,0,276,0,276,333.95999999999997953636921010911464691162109375
263,209059700,"SUTURA: CATGUT CRÓMICO, CALIBRE 2-0",TRAMITE USUAL,1.399999999999999911182158029987476766109466552734375,7368,120,0,7488,10483.199999999998908606357872486114501953125
264,209059800,"SUTURA: CATGUT CRÓMICO CALIBRE  2-0,  SE SOLICITA DE LONGITUD DE 75 CM CON AGUJA DE 37 MM PUNTA REDONDA DELGADA",TRAMITE USUAL,0.9499999999999999555910790149937383830547332763671875,4560,132,0,4692,4457.399999999999636202119290828704833984375
265,209059901,"SUTURA: CATGUT SIMPLE, CALIBRE 2-0, LONGITUD 67 A 75cm, AGUJA DE 20 A 22mm, ½ CÍRCULO, PUNTA REDONDA ESTÉRIL ",TRAMITE USUAL,1.3899999999999999023003738329862244427204132080078125,0,0,0,0,0
266,209060000,"SUTURA: CATGUT CRÓMICO, CALIBRE 3-0",TRAMITE USUAL,1.6999999999999999555910790149937383830547332763671875,13008,0,0,13008,22113.5999999999985448084771633148193359375
267,209060300,"SUTURA: CATGUT CROMICO, CALIBRE 4-0",TRAMITE USUAL,0.73158000000000000806466005087713710963726043701171875,0,0,24,24,17.557919999999999305373421520926058292388916015625
268,209060500,"SUTURA: CATGUT CRÓMICO, CALIBRE  5-0, LONGITUD 45 CM. AGUJA DE 12 o 13 MM., ⅜ CÍRCULO, PUNTA CORTANTE ESTÉRIL. ",TRAMITE USUAL,1.12000000000000010658141036401502788066864013671875,192,456,336,984,1102.080000000000154614099301397800445556640625
269,209062502,"SUTURA: POLIPROPILENO MONOFILAMENTO AZUL, CALIBRE 0",TRAMITE USUAL,0.87421000000000004259703700881800614297389984130859375,0,0,0,0,0
270,209062504,"SUTURA: POLIPROPILENO MONOFILAMENTO AZUL, CALIBRE 2-0, AGUJA REDONDA LONGITUD 75 A 90 CM. AGUJA DOBLE DE 25 A 26 MM., ½ CÍRCULO, PUNTA REDONDA ESTÉRIL. ",TRAMITE USUAL,1.1799999999999999378275106209912337362766265869140625,0,1056,0,1056,1246.079999999999927240423858165740966796875
271,209062506,"SUTURA DE POLIPROPILENO MONOFILAMENTO AZUL,CALIBRE1",TRAMITE USUAL,0.93152000000000001467270749344606883823871612548828125,0,2304,0,2304,2146.22208000000000538420863449573516845703125
272,209062602,"SUTURA: NYLON MONOFILAMENTO, CALIBRE 3-0",TRAMITE USUAL,0.51121000000000005325517804521950893104076385498046875,0,0,0,0,0
273,209062701,"SUTURA NYLON MONOFILAMENTO, CALIBRE 3-0 Con longitud 75 cm. con aguja de 24 mm., 3/8 circulo, punta cortantes reverso estéril.",TRAMITE USUAL,0.4699999999999999733546474089962430298328399658203125,0,0,0,0,0
274,209062704,"SUTURA: NYLON MONOFILAMENTO, CALIBRE 4-0",TRAMITE USUAL,0.49748999999999998777866494492627680301666259765625,0,0,0,0,0
275,209062902,SUTURA NYLON MONOFILAMENTO CALIBRE 10-0.      ,TRAMITE USUAL,5.980000000000000426325641456060111522674560546875,0,0,0,0,0
276,209063300,"SUTURA: NYLON MONOFILAMENTO, SE SOLICITA CALIBRE 6-0",TRAMITE USUAL,1.24500000000000010658141036401502788066864013671875,0,0,0,0,0
277,209063306,"SUTURA: NYLON MONOFILAMENTO, CALIBRE 5-0, LONGITUD 45 CM., AGUJA DE 19 MA 20 MM., ⅜ CÍRCULO, PUNTA CORTANTE. ",TRAMITE USUAL,0.8449999999999999733546474089962430298328399658203125,0,0,0,0,0
278,209063308,"SUTURA: POLIPROPILENO MONOFILAMENTO, CALIBRE 7-0",TRAMITE USUAL,2.645750000000000046185277824406512081623077392578125,0,576,0,576,1523.951999999999998181010596454143524169921875
279,209063313,"SUTURA MONOFILAMENTO POLIDIOXANONA CALIBRE 4-0 Descripción del producto: Sutura Monofilamento de Polidioxanona recubierta de triclosan ,incolora,    (SE SOLICITA: calibre 4-0,longitud 45cm, aguja de 19mm,3/8 circulo,punta cortante.)",TRAMITE USUAL,7.105000000000000426325641456060111522674560546875,0,0,0,0,0
280,209063318,"SOLUCION ADHESIVA TOPICA PARA LA SUTURA DE LA PIEL  (SE SOLICITA DE 0.5ML
ESTERIL DE USO UNICO, EN ENVASE BURBUJA CON PUNTA, APLICADOR, DE FORMULACION MONOMETRICA DE (2
OCTIL CIANOACRILATO) Y CON BARRERA MICROBIAL DE 0.25ML,0.50ML,0.75ML DE LIQUIDO ADHESIVO.)",TRAMITE USUAL,42.625,0,0,0,0,0
281,209063402,"SUTURA: ÁCIDO POLIGLICÓLICO TRENZADO, CALIBRE  0, (SE SOLICITA LONGITUD 75CM AGUJA DE 26 MM, 1/2 CIRCULO, PUNTA REDONDA GRUESA)",TRAMITE USUAL,1.3649999999999999911182158029987476766109466552734375,0,0,0,0,0
282,209063404,"SUTURA: ACIDO POLIGLICOLICO TRENZADO, CALIBRE 0, LONGITUD 70 CM. AGUJA DE 37 MM. GRUESA 1/2 CIRCULO, PUNTA REDONDA ESTERIL. ",TRAMITE USUAL,1.314999999999999946709294817992486059665679931640625,0,0,0,0,0
283,209063406,"SUTURA: ACIDO POLIGLICOLICO TRENZADO, CALIBRE 1, SE SOLICITA AGUJA DE 35 MM. LONGITUD 70CM",TRAMITE USUAL,1.2949999999999999289457264239899814128875732421875,0,0,0,0,0
284,209063500,"SUTURA: ÁCIDO POLIGLICÓLICO TRENZADA, CALIBRE 2-0",TRAMITE USUAL,1.5900000000000000799360577730112709105014801025390625,0,0,0,0,0
285,209063504,"SUTURA: ÁCIDO POLIGLICÓLICO TRENZADO, CALIBRE 1 LONGITUD 67 A 75 CM. AGUJA DE 35 A 37 MM., 1/2 CÍRCULO, PUNTA REDONDA GRUESA.                                                                                              SOLICITAMOS: AGUJA CALIBRE 36MM LONG 70CM ",TRAMITE USUAL,1.3899999999999999023003738329862244427204132080078125,12,0,0,12,16.67999999999999971578290569595992565155029296875
286,209063509,"SUTURA ACIDO POLIGLICOLICO TRENZADO, CALIBRE 4-0, SE SOLICITA AGUJA 19MM, 3/8 CIRCULO PUNTA CORTANTE ESTERIL, LONGITUD 45CM",TRAMITE USUAL,1.37999999999999989341858963598497211933135986328125,0,0,0,0,0
287,209063510,"SUTURA: ACIDO POLIGLICÓLICO TRENZADO, CALIBRE 4-0",TRAMITE USUAL,1.354999999999999982236431605997495353221893310546875,0,0,0,0,0
288,209063513,"SUTURA: ÁCIDO POLIGLICÓLICO TRENZADO, CALIBRE 3-0 ",TRAMITE USUAL,1.5800000000000000710542735760100185871124267578125,0,0,0,0,0
289,209063802,"SUTURA ACIDO POLIGLICOLICO TRENZADO, SE SOLICITA CALIBRE 6-0",TRAMITE USUAL,6.6699999999999999289457264239899814128875732421875,0,0,0,0,0
290,209064000,SUTURA: SEDA NEGRA TRENZADA SILICONIZADA CALIBRE 0,TRAMITE USUAL,0.91000000000000003108624468950438313186168670654296875,0,0,0,0,0
291,209064200,SUTURA: SEDA NEGRA TRENZADA SILICONIZADA CALIBRE 1.,TRAMITE USUAL,0.8649999999999999911182158029987476766109466552734375,11208,0,0,11208,9694.920000000000072759576141834259033203125
292,209064201,"SUTURA: SEDA NEGRA TRENZADA SILICONIZADA, CALIBRE 1,  SE SOLICITA   LONGITUD 75CM.,  10 HEBRAS",TRAMITE USUAL,1.58499999999999996447286321199499070644378662109375,0,0,0,0,0
293,209064400,"SUTURA: SEDA NEGRA TRENZADA SILICÓN IZADA CALIBRE 2.0, SE SOLICITA LONGITUD 75CM, 10 HEBRAS",TRAMITE USUAL,0.9050000000000000266453525910037569701671600341796875,0,0,0,0,0
294,209064500,"SUTURA: SEDA NEGRA TRENZADA SILICONIZADA CALIBRE 2.0, SE SOLICITA DE LONGITUD 75CM",TRAMITE USUAL,0.810000000000000053290705182007513940334320068359375,16860,552,0,17412,14103.72000000000116415321826934814453125
295,209064600,"SUTURA: SEDA NEGRA TRENZADA SILICÓNIZADA, CALIBRE 3-0",TRAMITE USUAL,1.0800000000000000710542735760100185871124267578125,0,0,0,0,0
296,209064701,"SUTURA: SEDA NEGRA TRENZADA SILICONIZADA, CALIBRE 3-0",TRAMITE USUAL,0.497840000000000004742872761198668740689754486083984375,0,0,0,0,0
297,209064800,SUTURA: SEDA NEGRA TRENZADA SILICONIZADA CALIBRE 3.0   SE SOLICITA AGUJA DE 22 MM,TRAMITE USUAL,1.75,0,0,0,0,0
298,209065300,"SUTURA: SEDA NEGRA TRENZADA SILICONIZADA, CALIBRE 4-0, LONGITUD 45cm, AGUJA DE 12 A 13mm, ⅜ CÍRCULO, PUNTA CORTANTE, ESTÉRIL",TRAMITE USUAL,0.7199999999999999733546474089962430298328399658203125,0,0,0,0,0
299,209065500,"SUTURA: SEDA NEGRA TRENZADA  SILICONIZADA, CALIBRE 6-0. SE SOLICITA LONGITUD 45 CM.  AGUJA DE 11 A 12 MM., 3/8 CIRCULO, PUNTA CORTANTE",TRAMITE USUAL,1.2800000000000000266453525910037569701671600341796875,0,288,0,288,368.6399999999999863575794734060764312744140625
300,209066101,"SUTURA: POLIPROPILENO MONOFILAMENTO CALIBRE 3-0, DE LONGITUD 90CM, DOBLE AGUJA DE 25 - 26MM, 1/2 CÍRCULO PUNTA REDONDA ESTÉRIL",TRAMITE USUAL,1.645000000000000017763568394002504646778106689453125,0,288,0,288,473.759999999999990905052982270717620849609375
301,209069700,PLANCHA DE CAUTERIO DESECHABLE,TRAMITE USUAL,3.285000000000000142108547152020037174224853515625,0,0,0,0,0
302,209076301,"APOSITO PROTECTOR, SE SOLICITA TAMAÑO 10CM X 10CM",TRAMITE USUAL,16.80499999999999971578290569595992565155029296875,0,0,0,0,0
303,209076401,"APOSITO DE ESPUMA, se solicita Tamaños con borde 15 CM X 20 CM",TRAMITE USUAL,38.7000000000000028421709430404007434844970703125,0,0,0,0,0
304,209076501,"APOSITO DE ESPUMA, se solicita Tamaños sin borde 12.5CM X 12.5CM",TRAMITE USUAL,26.5,0,0,0,0,0
305,209076601,"APOSITO DE ESPUMA, se solicita Tamaños SIN BORDEN 20CM X 20CM",TRAMITE USUAL,47.7999999999999971578290569595992565155029296875,0,0,0,0,0
306,209076701,"CAPA POROSA O BIOMATRIZ, SE SOLICITA TAMAÑO 10 cm x 10 cm, con 420 agujeros de 1600 micrones.",TRAMITE USUAL,60,1420,1320,100,2840,170400
307,209077401,"SOLUCIÓN PARA LAVADO, IRRIGACIÓN Y DESBRIDAMIENTO DE HERIDAS, se solicita Botella con tapa rosca 500ml",TRAMITE USUAL,25,0,0,0,0,0
308,209077501,"SOLUCIÓN PARA LAVADO, IRRIGACIÓN Y DESBRIDAMIENTO DE HERIDAS, se solicita, Dispensador en aerosol con tapa atomizador 250 ml",TRAMITE USUAL,20.25,0,0,0,0,0
309,209077601,"SOLUCIÓN PARA LAVADO, IRRIGACIÓN Y DESBRIDAMIENTO DE HERIDAS, se solicita tamaño en bolsas con puerto de irrigación de 1000 ml.",TRAMITE USUAL,62.405000000000001136868377216160297393798828125,0,0,0,0,0
310,209077701,"SOLUCIÓN PARA LAVADO, IRRIGACIÓN Y DESBRIDAMIENTO DE HERIDAS, SE SOLICITA EL TAMAÑO Compresa presaturada Empaque individual de gasa de 8 capas de 10 cm x 10 cm.",TRAMITE USUAL,6.90500000000000024868995751603506505489349365234375,0,0,0,0,0
311,209077801,"SOLUCIÓN PARA LAVADO, IRRIGACIÓN Y DESBRIDAMIENTO DE HERIDAS SE SOLICITA, Gel Dispensador en spray aerosol 100 g.",TRAMITE USUAL,47.50500000000000255795384873636066913604736328125,0,0,0,0,0
312,209091701,"ESPUMA DE POLIURETANO (PU) CON SISTEMA DE CONTROL DE CARGA DE TRANSPIRACIÓN CONTINUA, se solicita 4"" x 5"" (10.2 cm x 12.7 cm)",TRAMITE USUAL,28.89999999999999857891452847979962825775146484375,0,0,0,0,0
313,209091801,"ESPUMA DE POLIURETANO (PU) CON SISTEMA DE CONTROL DE CARGA DE TRANSPIRACIÓN CONTINUA, se solicita ""8x8""(20.3 cm x 20.3 cm)",TRAMITE USUAL,73.4200000000000017053025658242404460906982421875,0,0,0,0,0
314,209091901,"ESPUMA DE POLIURETANO CON SISTEMA DE CONTROL DE CARGA IMPERMEABLE, se solicita ""4 x 5"" (10.2cm x 12.7 cm)",TRAMITE USUAL,27.800000000000000710542735760100185871124267578125,0,0,0,0,0
315,209092001,"ESPUMA DE POLIURETANO CON SISTEMA DE CONTROL DE CARGA IMPERMEABLE, se solicita ""8x8""(20.3 cm x 20.3 cm)",TRAMITE USUAL,73.4200000000000017053025658242404460906982421875,0,0,0,0,0
316,209092101,"ESPUMA DE ALCOHOL POLIVINILICO CON SISTEMA DE CONTROL DE CARGA,    (SE SOLICITA ,EXUDADO MODERADO SIN PELÍCULA DE RETENCIÓN DE HUMEDAD 15.2 cm x 15.2 cm (6” x 6”).",TRAMITE USUAL,14.6099999999999994315658113919198513031005859375,0,135,190,325,4748.25
317,209092201,"ESPUMA DE ALCOHOL POLIVINILICO CON SISTEMA DE CONTROL DE CARGA,      (SE SOLICITA PARA TUNELIZACION DE 9 mm (1.2g)",TRAMITE USUAL,14.6099999999999994315658113919198513031005859375,24160,620,0,24780,362035.7999999999883584678173065185546875
318,209092301,"ESPUMA DE ALCOHOL POLIVINILICO CON SISTEMA DE CONTROL DE CARGA,     (SE SOLICITA, EXUDADO MODERADO SIN PELÍCULA DE RETENCIÓN DE HUMEDAD, TAMAÑO 10.2 cm x 10.2 cm  x 1.29 cm (4"" x 4"" x 0.5"")",TRAMITE USUAL,56.25,0,570,0,570,32062.5
319,209092401,"ESPUMA DE ALCOHOL POLIVINILICO CON SISTEMA DE CONTROL DE CARGA,    ( SE SOLICITA , EXUDADO ABUNDANTE SIN PELÍCULA DE RETENCIÓN DE HUMEDAD TAMAÑO De forma isla adherente de 10.2 cm x 12 cm (4"" x 4.75"") y espuma de 5 cm x 7 cm (2"" x 2.75"").",TRAMITE USUAL,34.97999999999999687361196265555918216705322265625,0,0,0,0,0
320,209094100,CUCHILLA PARA PODADORA DE VELLOS Y CABELLOS CON SISTEMA OSCILANTE (Ofrecer Nueva Tecnologia) SE SOLICITAN UN MINIMO DE 100,TRAMITE USUAL,3.104999999999999982236431605997495353221893310546875,0,0,0,0,0
321,209100700,ESPECULO VAGINAL (SE SOLICITA TAMAÑO CHICO),TRAMITE USUAL,0.2220000000000000028865798640254070051014423370361328125,0,0,0,0,0
322,209100701,ESPECULO VAGINAL (SE SOLICITA TAMAÑO MEDIANO),TRAMITE USUAL,1.2350000000000000976996261670137755572795867919921875,0,0,0,0,0
323,209100702,ESPECULO VAGINAL (SE SOLICITA TAMAÑO GRANDE)  ,TRAMITE USUAL,1.229999999999999982236431605997495353221893310546875,10600,0,2000,12600,15498
324,209111100,"SUTURA ÁCIDO POLIGLICOLICO TENZADO, SE SOLICITA CALIBRE 3-0",TRAMITE USUAL,0.93891000000000002234656903965515084564685821533203125,32012,504,0,32516,30529.5975600000019767321646213531494140625
325,209111200,SUTURA DE ÁCIDO POLIGLICÓLICO CALIBRE 0 DE 60-75CM DE LONGITUD.,TRAMITE USUAL,3.345000000000000195399252334027551114559173583984375,0,0,0,0,0
326,209111300,"MATRIZ EXTRACELULAR TRIDIMENSIONAL, SE SOLICITA 7 x 20CM, MALLA",TRAMITE USUAL,295.6000000000000227373675443232059478759765625,0,0,0,0,0
327,209111600,"MATRIZ DE CELULOSA OXIDADA REGENERADA Y COLÀGENO, SE SOLICITA TAMAÑO 123 CENTIMETROS CUADRADOS.                                                                                                                                                                                                                                                                      ",TRAMITE USUAL,54.7999999999999971578290569595992565155029296875,0,0,0,0,0
328,209112500,INSTRUMENTO O PINZA CURVA PARA FUSION DE TEJIDOS PARA ELECTROCAUTERIO MULTIMODAL O BIPOLAR AVANZADO (CIRUGIA ABIERTA) DESECHABLE,TRAMITE USUAL,625,0,168,0,168,105000
329,209112600,PINZA LAPARASCOPICA DE 10 MM CON CORTE INCORPORADO PARA SELLADO DE VASOS SANGUINEOS MEDIANTE PRESION.                                                                                                                                                         ,TRAMITE USUAL,404.75,0,0,0,0,0
330,209112700,"LAPIZ PARA ELECTROCAUTERIO MULTIMODAL (CORTE,DISECCION Y COAGULACION)                                                                                                                                                                                                                                                             ",TRAMITE USUAL,43.21000000000000085265128291212022304534912109375,0,0,0,0,0
331,209112800,"PINZA PARA FUSION DE TEJIDOS Y DISECCION MONOPOLAR DE 5MM LAPARASCOPICA PARA ELECTROCAUTERIO MULTIMODAL, Se Solicita de 37 Long, mandibula curva. ",TRAMITE USUAL,846.5399999999999636202119290828704833984375,0,0,0,0,0
332,209112900,PINZA LAPARASCOPICA DE 5 MM CON CORTE INCORPORADO PARA SELLADO DE VASOS SANGUINEOS MEDIANTE PRESION.                                                                                                                              ,TRAMITE USUAL,587.5,0,28,0,28,16450
333,209113300,"TROCAR PARA CIRUGIA LAPAROSCOPICA DE 2MM A 15MM DE DIAMETRO, PUNTA CORTANTE DESECHABLE CON PROTECCION ACTIVA Y REDUCTOR INCORPORADO",TRAMITE USUAL,64.6200000000000045474735088646411895751953125,912,0,0,912,58933.4400000000023283064365386962890625
334,209113400,INSTRUMENTO PARA PROLAPSO RECTAL Y HEMORROIDES,TRAMITE USUAL,199.5,52,48,0,100,19950
335,209113500,TROCAR PARA CIRUGIA LAPAROSCOPICA  DE 5MM A 12MM DE DIAMETRO CON SISTEMA DE ANCLAJE (TIPO HASSAN O TÉCNICA ABIERTA) PUNTA ROMA DESECHABLE.                                             ,TRAMITE USUAL,68.344999999999998863131622783839702606201171875,0,0,0,0,0
336,209113600,"MALLA TRI-LAMINADA DELGADA.  (SE SOLICITA TAMAÑO 8"" X 12"" (20 X 30cm))",TRAMITE USUAL,1651.430000000000063664629124104976654052734375,0,0,0,0,0
337,209113700,HEMOSTATICO ABSORVIBLE DE TEXTURA ALGODONOSA            (SE SOLICITA: TAMAÑO: 2.5 X 5CM),TRAMITE USUAL,110,0,0,0,0,0
338,209119500,SUTURA MONOFILAMENTO POLIDIOXANONA  CALIBRE 1  (SE SOLICITA AGUJA  70MM ),TRAMITE USUAL,19.699999999999999289457264239899814128875732421875,0,0,0,0,0
339,209119600,"SUTURA MONOFILAMENTO SINTETICO ABSORBIBLE, SE SOLICITA CALIBRE 5-0",TRAMITE USUAL,1.559390000000000053859139370615594089031219482421875,21600,240,0,21840,34057.077600000004167668521404266357421875
340,209119700,"SUTURA: MONOFILAMENTO SINTETICO ABSORBIBLE, CALIBRE 4-0 ",TRAMITE USUAL,1.3675699999999999523225824304972775280475616455078125,0,576,0,576,787.7203200000000151703716255724430084228515625
341,209119900,"CANULA DE ASPIRACION TIPO YANKEUER. SE SOLICITA TIPO RIGIDA DE ADULTO de 12"" y tuberia de 72"" o MAS",TRAMITE USUAL,1.5449999999999999289457264239899814128875732421875,0,0,0,0,0
342,209125001,"SISTEMA DE ENGRAPADO O LIGADURA, PARA CLIP DE POLIMERO NO ABSORBIBLE",TRAMITE USUAL,89.590000000000003410605131648480892181396484375,0,0,0,0,0
343,209155001,"GUANTES QUIRÚRGICOS LIBRES DE LATEX Y POLVO, ESTÉRIL  SE SOLICITA TAMAÑO 6 1/2",TRAMITE USUAL,1.3049999999999999378275106209912337362766265869140625,0,0,0,0,0
344,209155101,"GUANTES QUIRÚRGICOS LIBRES DE LATEX Y POLVO, ESTÉRIL                      (SE SOLICITA TAMAÑO 7)",TRAMITE USUAL,1.6399999999999999023003738329862244427204132080078125,0,0,0,0,0
345,209155201,"GUANTES QUIRÚRGICOS LIBRES DE LATEX Y POLVO, ESTÉRIL . SE SOLICITA TAMAÑO 7.5",TRAMITE USUAL,1.6399999999999999023003738329862244427204132080078125,0,0,0,0,0
346,209158201,GLUCONATO DE CLORHEXIDINA AL 4% EN ESPUMA PARA ANTISEPSIA DE MANO.   ( LA EMPRESA QUE SE LE ADJUDIQUE DEBE PROPORCIONAR ELSISTEMA DE DISPENSACION POR BOMBA DE PIE) ,TRAMITE USUAL,28.934999999999998721023075631819665431976318359375,0,0,0,0,0
347,209158301,"GUANTES DE NITRILO PARA EXAMEN SIN POLVO, NO ESTÉRIL.       (SE SOLICITA TAMAÑO MEDIANO)",TRAMITE USUAL,0.0350000000000000033306690738754696212708950042724609375,0,0,0,0,0
348,209158401,"GUANTES DE NITRILO PARA EXAMEN SIN POLVO, NO ESTÉRIL.     (SE SOLICITA TAMAÑO GRANDE)",TRAMITE USUAL,0.0350000000000000033306690738754696212708950042724609375,0,0,0,0,0
349,209160401,SOLUCION QUIRURGICA ANTISEPTICO PARA LA PIEL. SE SOLICITA VOLUMEN DE 26ML,TRAMITE USUAL,11.3100000000000004973799150320701301097869873046875,0,0,0,0,0
350,209163501,"SUTURA: POLIPROPILENO MONOFILAMENTO, CALIBRE 6-0  ( 1/2 de circulo)",TRAMITE USUAL,4.45999999999999996447286321199499070644378662109375,0,0,0,0,0
351,209163901,"INJERTO VASCULAR CONICO CON ANILLOS INTEGRADOS AL PTFE.   (SE SOLICITA: CON HEPARINA BIOACTIVA, CAN ANILLO INTEGRAD, INJERTO VASCULAR CÓNICO Entre 4MM y 6MM ,Longitud 45CM).",TRAMITE USUAL,1815,0,0,0,0,0
352,209168001,"INJERTO VASCULAR CONICO CON ANILLOS INTEGRADOS AL PTFE.   SE SOLICITA:  CON HEPARINA BIOACTIVA, CAN ANILLO INTEGRAD, INJERTO VASCULAR CÓNICO ENTRE 4MM y  7MM , LONGITUD 45CM",TRAMITE USUAL,1850,150,0,0,150,277500
353,209170601,"ESPIROMETRO INCENTIVO PARA REALIZAR EJERCICIOS DE RESPIRACION PROFUNDA.
(DESECHABLE):",TRAMITE USUAL,19.9456899999999990313881426118314266204833984375,15576,264,288,16128,321684.088319999980740249156951904296875
354,209171801,LENTE INTRAOCULAR PLEGABLE DE ACRILICO HIDROFOBICO DE +10.00 A +30.00 DIOPTRIAS.,TRAMITE USUAL,39.89999999999999857891452847979962825775146484375,101,2,0,103,4109.6999999999998181010596454143524169921875
355,209175902,"CEPILLO PARA LAVADO QUIRURGICO DESECHABLE CON CLOREXIDINA AL 4%,ESTERIL",TRAMITE USUAL,0.68000000000000004884981308350688777863979339599609375,0,0,0,0,0
356,209193700,DELANTAL PROTECTOR DE FLUIDOS   (JUMSUIT) ,TRAMITE USUAL,41.13000000000000255795384873636066913604736328125,189900,5600,6400,201900,8304147.000000000931322574615478515625
357,209196401,"Cuchillete con Mango de 15º hasta 45º  (se solicita de 15°) Desechable, esteril, con hoja en forma de lanceta de una sola pieza de 3 a 5mm.",TRAMITE USUAL,10.949999999999999289457264239899814128875732421875,390,0,0,390,4270.5
358,209203101,GLUCONATO DE CLORHEXIDINA AL 2% EN ESPUMA PARA ANTISEPSIA DE MANO. ( LA EMPRESA QUE SE LE ADJUDIQUE DEBE PROPORCIONAR EL SISTEMA DE DISPENSACION POR BOMBA DE PIE)  ,TRAMITE USUAL,19.25,0,0,0,0,0
359,209214901,CANULA NASOFARINGEA DE 32 FR A 36 FR.                 (SE SOLOCITA TAMAÑ0 32FR) ,TRAMITE USUAL,3.693599999999999994315658113919198513031005859375,4040,200,0,4240,15660.863999999999577994458377361297607421875
360,209215001,CANULA NASOFARINGEA  DE 32 FR A 36 FR.                        (SE SOLOCITA TAMAÑ0 34FR),TRAMITE USUAL,3.686599999999999877076106713502667844295501708984375,1460,200,0,1660,6119.755999999999403371475636959075927734375
361,209215101,CANULA NASOFARINGEA  DE 28 FR A 30 FR. SE SOLOCITA TAMAÑ0 30FR      ,TRAMITE USUAL,3.693400000000000016342482922482304275035858154296875,0,600,0,600,2216.0399999999999636202119290828704833984375
362,209215201,CANULA NASOFARINGEA  DE 28 FR A 30 FR. SE SOLOCITA TAMAÑ0 28FR   ,TRAMITE USUAL,3.653999999999999914734871708787977695465087890625,180,200,0,380,1388.51999999999998181010596454143524169921875
363,209223001,"CAL SODADA SIN PRODUCCION DEL COMPUESTO A. SE SOLICITA BOLSA DE 1KG• Indicador de violeta de etilo <1%• Hidróxido de calcio de porcentaje de peso >75%.• En caso que contenga catalizador: Cloruro de litio de % de peso entre 0% y 3% ó Hidróxido de Sodio entre 0% y 2%
",TRAMITE USUAL,110.1650000000000062527760746888816356658935546875,0,0,0,0,0
364,209235401,"GASA 2"" X 2"" X 16 DOBLECES, ESTÉRIL",TRAMITE USUAL,0.0299999999999999988897769753748434595763683319091796875,0,0,0,0,0
365,209235501,"GASA 2"" X 2"" X 16 DOBLECES CON ELEMENTO RADIOPACO, ESTERIL",TRAMITE USUAL,0.0330000000000000015543122344752191565930843353271484375,0,0,0,0,0
366,209235601,"GASA 3"" X 3"" X 16 DOBLECES, ESTERIL",TRAMITE USUAL,0.066000000000000003108624468950438313186168670654296875,0,0,0,0,0
367,209235801,"GASA 8"" X 4"" X 16 DOBLECES, ESTÉRIL",TRAMITE USUAL,0.0697200000000000041922021409845910966396331787109375,0,0,0,0,0
368,209235901,"GASA 8"" X 4"" X 16 DOBLECES CON ELEMENTOS RADIOPACO, ESTÉRIL",TRAMITE USUAL,0.2600000000000000088817841970012523233890533447265625,0,0,0,0,0
369,209236101,"GASA SIMPLE 4"" X 4"" X 16 ESTÉRIL",TRAMITE USUAL,0.2099999999999999922284388276239042170345783233642578125,0,0,0,0,0
370,209244001,"AGUJAS PARA LOCALIZACION Y BLOQUEO DE NERVIO PERIFERICO.                             (SE SOLICITA TAMAÑO 22Ga X 2"").",TRAMITE USUAL,11.800000000000000710542735760100185871124267578125,0,40,0,40,472
371,209268501,"CIRCUITO DESECHABLE DE VENTILADOR INTEGRADO DE HUMIDIFICACIÓN PASIVA Y
FILTRACIÓN DE 72 HORAS DE USO",TRAMITE USUAL,79,0,770,0,770,60830
372,209269601,"GUANTES DE NITRILO PARA EXAMEN SIN POLVO, NO ESTÉRIL. SE SOLICITA TAMAÑO CHICO",TRAMITE USUAL,0.0350000000000000033306690738754696212708950042724609375,0,0,0,0,0
373,209270001,"SET DE ROPA
",TRAMITE USUAL,12.339999999999999857891452847979962825775146484375,17296,0,0,17296,213432.63999999998486600816249847412109375
374,209286501,"CINTURON SEGURIDAD PARA MARCHA DE ADULTO                    (SE SOLICITA TAMAÑO PEQUEÑA DE 34""-30"")",TRAMITE USUAL,82.7233599999999995588950696401298046112060546875,5,0,0,5,413.616800000000012005330063402652740478515625
375,209286601,"CINTURON SEGURIDAD PARA MARCHA ADULTO.  (SE SOLICITA MEDIANO 30""-44"")",TRAMITE USUAL,110,146,0,0,146,16060
376,209286701,"CINTURON SEGURIDAD PARA MARCHA DE ADULTO.         (SE SOLICITA GRANDE 44""-60"")",TRAMITE USUAL,82.7233899999999948704498820006847381591796875,108,76,0,184,15221.10375999999814666807651519775390625
377,209292901,BOLSA PARA OBTENCIÓN DE MUESTRAS EN CIRUGÍA LAPAROSCÓPICA (Se solicita de 6.4cm x 15cm),TRAMITE USUAL,150,0,0,0,0,0
378,209296301,TIJERA PARA CORTE Y LIGADURA DE CORDÓN UMBILICAL CON BISTURÍ. ,TRAMITE USUAL,183.75,0,0,0,0,0
379,209298301,SET DE ROPA DESECHABLE PARA CIRUGIA OFTALMOLOGICA,TRAMITE USUAL,39.99000000000000198951966012828052043914794921875,3216,0,200,3416,136605.83999999999650754034519195556640625
380,209313501,"CUCHILLETE     (SE SOLICITA  2,2mm)",TRAMITE USUAL,11.9399999999999995026200849679298698902130126953125,762,0,360,1122,13396.6800000000002910383045673370361328125
381,209321101,SISTEMA DE DRENAJE TORACICO DE TRES CAMARAS. SE SOLICITA DRENAJE CERRADO DE 1 TUBO,TRAMITE USUAL,37.125,0,0,0,0,0
382,209330401,"RESPIRADORES CONTRA PARTICULAS DE ALTA FILTRACION N95 CON O SIN VALVULA DE EXALACION.                                                                                                   (SOLICITAMOS TAMAÑO MEDIANO ,SIN VALVULA DE EXALACION)",TRAMITE USUAL,0.9699999999999999733546474089962430298328399658203125,0,0,0,0,0
383,209332801,BANDEJA DE ANESTESIA EPIDURAL CONTINUA DESECHABLE CON MEDICAMENTO. SE SOLICITA AGUJA TUOHY/HUBER DE 17G X 88 a 90mm SIN ALAS,TRAMITE USUAL,30,0,0,150,150,4500
384,209338801,"EMPAQUES O COMPRESA CALIENTE (SE SOLICITA CONTORNO PARA CUELLO 61X15 CM 24"" X 6"")",TRAMITE USUAL,36.64088000000000278078005067072808742523193359375,0,20,0,20,732.817600000000084037310443818569183349609375
385,209355401,"BOLSA MIXTA TERMOSELLABLE PARA ESTERILIZAR, 6"" X 12"" (150 X 300MM)",TRAMITE USUAL,0.11000000000000000055511151231257827021181583404541015625,0,19200,0,19200,2112
386,209375401,"JUEGO COMPLETO PARA CATETERIZACIÓN VESICAL CON SONDA FOLEY SE SOLICITA 16Fr DE SILICONA, CAPACIDAD DE BOLSA DE 2000cc, Solución para limpieza de Clorexidina acuosa al 1% CON Jeringuilla prellenada con agua bidestilada de  10cc CON UN PAR DE GUANTES DE NITRILO O VINILO",TRAMITE USUAL,15.910000000000000142108547152020037174224853515625,4880,280,0,5160,82095.60000000000582076609134674072265625
387,209375601,"JUEGO COMPLETO PARA CATETERIZACIÓN VESICAL CON SONDA FOLEY SE SOLICITA 18Fr DE SILICONA, CAPACIDAD DE BOLSA DE 2000cc, Solución para limpieza de Clorexidina acuosa al 1% CON Jeringuilla prellenada con agua bidestilada de  10cc CON UN PAR DE GUANTES DE NITRILO O VINILO",TRAMITE USUAL,13,9530,600,120,10250,133250
388,209377501,"GUANTES QUIRÚRGICOS LIBRES DE LATEX Y POLVO, ESTÉRIL  SE SOLICITA TAMAÑO 6",TRAMITE USUAL,1.6399999999999999023003738329862244427204132080078125,0,0,0,0,0
389,209393201,APOSITO DE ESPUMA 3D CON PLATA IONICA SE SOLICITA APOSITO NO ADHESIVO TAMAÑO 10X 10CM ,TRAMITE USUAL,21,3780,700,0,4480,94080
390,209416401,"JUEGO COMPLETO PARA SUCCIÓN DE VÍAS RESPIRATORIAD, PEDIATRICO Y ADULTO. SE SOLICITA TAMAÑO 6FR",TRAMITE USUAL,1.37000000000000010658141036401502788066864013671875,0,0,0,0,0
391,209419501,DETERGENTE LIQUIDO CON ENZIMAS (SE SOLICITA DE 4 ENZIMA),TRAMITE USUAL,35.63000000000000255795384873636066913604736328125,788,84,224,1096,39050.4800000000032014213502407073974609375
392,209419601,TORRE DE HISTEROSCOPIA DE FLUJO CONTINUO PARA GINECOLOGIA:   SE SOLICITA ACCESORIO  JUEGOS DE TUBOS DE SILICON REUSABLE,TRAMITE USUAL,55.3599999999999994315658113919198513031005859375,0,0,0,0,0
393,209422201,"MULTICAPA DE TRIPLEACCION A BASE DE OCTENIDINA Y ACIDO HIALURONICO TAMAÑO: 10CM X 10CM (3.9"" X 3.9"")",TRAMITE USUAL,0.11000000000000000055511151231257827021181583404541015625,7920,0,0,7920,871.200000000000045474735088646411895751953125
394,209423401,CATETER DE ARTERIA RADIAL PARA MONITORIZACION DE PRESION Y TOMA DE MUESTRAS SE SOLICITA CON ALETAS DE 3Fr Y 5cms DE LONGITUD DE POLIURETANO CON PUNTA RECTA,TRAMITE USUAL,76,0,0,0,0,0
395,209434101,TIJERA PARA BISTURI ARMONICO CON CONTROL MANUAL Y ALTA FRECUENCIA.  (SE SOLICITA VASTAGO DE 9CM),TRAMITE USUAL,1090,0,0,0,0,0
396,209443301,"GUANTES QUIRÚRGICOS DE LÁTEX, ESTÉRIL (Se solicita tamaño 6)                                                                                                                                                                                                                                                     ",TRAMITE USUAL,0.27500000000000002220446049250313080847263336181640625,0,0,0,0,0
397,209454501,BOLSA INFUSORA A PRESION .SE SOLICITA BOLSA DE 1000cc DE CAPACIDAD,TRAMITE USUAL,51.38000000000000255795384873636066913604736328125,0,170,0,170,8734.600000000000363797880709171295166015625
398,209458401,MATRIZ EXTRACELULAR TEJIDO FIBROSO (Se solicita de 5 x 5cm) ,TRAMITE USUAL,70.06999999999999317878973670303821563720703125,0,0,0,0,0
399,209459201,SET DE ROPA PARA CITOSCOPÍA,TRAMITE USUAL,25.980000000000000426325641456060111522674560546875,16358,116,0,16474,427994.5200000000186264514923095703125
400,209462801,FERULAS SINTETICAS EN ROLLO SE SOLICITA DE 7.5CM X 4.6M,TRAMITE USUAL,112.06000000000000227373675443232059478759765625,0,0,0,0,0
401,209462901,FERULA SINTETICAS EN ROLLO SE SOLICITA DE 12.5CM X 4.6M,TRAMITE USUAL,163.8799999999999954525264911353588104248046875,340,0,32,372,60963.360000000000582076609134674072265625
402,209464201,FERULAS SINTETICAS EN ROLLO SE SOLICITA DE 5CM X 4.6M,TRAMITE USUAL,92.0400000000000062527760746888816356658935546875,0,82,0,82,7547.280000000000654836185276508331298828125
403,209464301,"FERULAS SINTETICAS EN ROLLO SE SOLICITA DE 10CM X 4,6M",TRAMITE USUAL,138.5,0,0,0,0,0
404,209471301,JUEGO DE ROPA DESECHABLE PARA CAMA DE PACIENTE,TRAMITE USUAL,3.390000000000000124344978758017532527446746826171875,38960,0,720,39680,134515.2000000000116415321826934814453125
405,209472501,"VENDA DE YESO DE POLIESTER SE SOLICITA 5""X4 YARDAS. ",TRAMITE USUAL,6.230000000000000426325641456060111522674560546875,15906,600,0,16506,102832.380000000004656612873077392578125
406,209472601,BANDEJA PARA INSERCION DE SONDA VESICAL ,TRAMITE USUAL,1.899999999999999911182158029987476766109466552734375,0,0,0,0,0
407,209479001,BOLSA INFUSORA A PRESION. SE SOLICITA BOLSA DE 500cc DE CAPACIDAD,TRAMITE USUAL,21.60000000000000142108547152020037174224853515625,0,0,0,0,0
408,209484301,"BANDEJA PARA CATETERIZACION VENOSO CENTRAL DOBLE LUMEN NEONATAL.  SE SOLICITA 4FR X 5CM, DE POLIURETANO",TRAMITE USUAL,64.5,360,0,0,360,23220
409,209484401,"BANDEJA PARA CATETERIZACION VENOSO CENTRAL DOBLE LUMEN NEONATAL.  SE SOLICITA 4FR X 8CM, DE POLIURETANO",TRAMITE USUAL,64.5,0,0,0,0,0
410,209484701,BANDEJA PARA CATETERIZACION VENOSO CENTRAL TRIPLE LUMEN PEDIATRICA. SE SOLICITA MATERIAL DE CATETER CON POLIURETANO DIAMETRO 5 FR X 8CM DE LONGITUD.,TRAMITE USUAL,73.5,0,0,0,0,0
411,209484801,BANDEJA PARA CATETERIZACION VENOSO CENTRAL TRIPLE LUMEN PEDIATRICA.   SE SOLICITA MATERIAL DE CATETER CON POLIURETANO DIAMETRO 5FR X 12CM DE LONGITUD,TRAMITE USUAL,162,0,0,0,0,0
412,209485301,"SUTURA: POLIPROPILENO MONOFILAMENTO, CALIBRE 5-0.(SE SOLICITA LONGITUD DE 75 CM) ",TRAMITE USUAL,3.970000000000000195399252334027551114559173583984375,0,24,0,24,95.280000000000001136868377216160297393798828125
413,209485401,PERILLA (BULBO) DE SUCCION - IRRIGACION DE 2 ONZAS ESTERIL,TRAMITE USUAL,0.6550000000000000266453525910037569701671600341796875,2801,1200,0,4001,2620.65500000000020008883439004421234130859375
414,209485501,GUANTES QUIRURGICO DE LATEX ESTERIL                                                               (SE SOLICITA TAMAÑO 8 1/2),TRAMITE USUAL,0.27500000000000002220446049250313080847263336181640625,0,0,0,0,0
415,209485901,BANDAS ELÁSTICAS PARA FORTALECIMIENTO SE SOLICITA ULTRA SUAVE,TRAMITE USUAL,103.91406000000000631189323030412197113037109375,146,23,28,197,20471.06982000000061816535890102386474609375
416,209486001,BANDAS ELÁSTICAS PARA FORTALECIMIENTO   (SE SOLICITA MEDIANA),TRAMITE USUAL,102.38600999999999885403667576611042022705078125,0,0,0,0,0
417,209486101,BANDAS ELÁSTICAS PARA FORTALECIMIENTO                     (SE SOLICITA FUERTE) ,TRAMITE USUAL,100,174,22,29,225,22500
418,209486201,BANDAS ELÁSTICAS PARA FORTALECIMIENTO                       (SE SOLICITA -EXTRA FUERTE),TRAMITE USUAL,126.549890000000004874891601502895355224609375,14,24,19,57,7213.3437300000005052424967288970947265625
419,209486401,BANDAS ELÁSTICAS PARA FORTALECIMIENTO                     (SE SOLICITA -SUPER FUERTE),TRAMITE USUAL,100,0,2,18,20,2000
420,209489901,"APOSITO ELECTROESTATICO LAMINADO DE CARBON ACTIVADO DE BAJA ADHERENCIA SE SOLICITA TAMAÑO: 20 CM X 10 CM (8"" X 4"")",TRAMITE USUAL,36.75,3620,0,0,3620,133035
421,209493501,BANDAS ELÁSTICAS PARA FORTALECIMIENTO.                    (SE SOLICITA SUAVE),TRAMITE USUAL,103.91406000000000631189323030412197113037109375,0,21,0,21,2182.19525999999996201950125396251678466796875
422,209496501,"APOSITO ELECTROESTÁTICO DE TRIPLE ACCIÓN SE SOLICITA TAMAÑO: 10 CM X 10 CM (4"" X 4"")",TRAMITE USUAL,24,0,0,0,0,0
423,209518001,"APÓSITO HIDROCOLOIDE (Estándar, Regular o Extra Absorbente).  SE SOLICITA  CUADRADO 10CM X 10CM",TRAMITE USUAL,2.975000000000000088817841970012523233890533447265625,1240,740,0,1980,5890.5
424,209519101,RECIPIENTE DESECHABLE PARA SISTEMA DE DRENAJE TORÁCICO DIGITAL (Se solicita de 300cc polipropileno) ,TRAMITE USUAL,16.75,440,0,0,440,7370
425,209521601,"AGUJAS PARA LOCALIZACION Y BLOQUEO DE NERVIO PERIFERICO.  SE SOLICITA TAMAÑO 22Ga X 3 1/4"" ",TRAMITE USUAL,11.800000000000000710542735760100185871124267578125,60,0,0,60,708
426,209540801,HIALURONATO SÓDICO,TRAMITE USUAL,25.8900000000000005684341886080801486968994140625,0,110,0,110,2847.90000000000009094947017729282379150390625
427,209541001,"FORRO PROTECTOR DE COLCHON SE SOLICITA TAMAÑO 38"" X 80""",TRAMITE USUAL,44.88000000000000255795384873636066913604736328125,160,1400,0,1560,70012.800000000002910383045673370361328125
428,209542201,"SUTURA: ACIDO POLIGLICÓLICO TRENZADO, CALIBRE 3-0, LONGITUD 67 A 75 CM.  AGUJA DE 15 A 17 MM., 1/2 CIRCULO, PUNTA REDONDA. SE SOLICITA LONGITUD DE 75CM Y AGUJA DE 15MM",TRAMITE USUAL,1.33499999999999996447286321199499070644378662109375,1248,0,0,1248,1666.079999999999927240423858165740966796875
429,209546001,MASCARILLA RECTANGULAR DE 3 PLIEGUES CON SUJECION EN LA OREJA. ,TRAMITE USUAL,0.309999999999999997779553950749686919152736663818359375,330000,0,24000,354000,109740
430,209546301,"BATA DESECHABLE, PARA USO GENERAL NO ESTERIL .AAMI     NIVEL 3.  SE SOLICITA TAMAÑO REGULAR O UNIVERSAL (MEDIANO -GRANDE)",TRAMITE USUAL,0.57809999999999994724220186981256119906902313232421875,0,0,0,0,0
431,209546401,"BATA DESECHABLE, PARA USO GENERAL NO ESTERIL .AAMI NIVEL 3.       (SE SOLICITA TAMAÑO GRANDE)",TRAMITE USUAL,0.5949999999999999733546474089962430298328399658203125,0,0,0,0,0
432,209559101,VENDAJE NEUROMUSCULAR. SE SOLICITA DE 5CM X 5MT,TRAMITE USUAL,12.5,0,0,0,0,0
433,209559201,"MUÑEQUERA CON BARRA DE 6” U 8” DERECHA O IZQUIERA, CON CIERRE DE VELCRO. SE SOLICITA  TAMAÑO CHICO",TRAMITE USUAL,40.68999999999999772626324556767940521240234375,0,0,0,0,0
434,209559401,"INMOVILIZADOR DE RODILLA UNIVERSAL. SE SOLICITA TAMAÑO  16"" DE LONGITUD",TRAMITE USUAL,44.77799999999999869260136620141565799713134765625,0,0,0,0,0
435,209559601,INMOVILIZADOR ELÁSTICO DE HOMBRO                           (SE SOLICITA TAMAÑO SMALL)    ,TRAMITE USUAL,44.64999999999999857891452847979962825775146484375,0,0,0,0,0
436,209559701,"CALCETA TUBULAR.    SE SOLICITA  MEDIA TEJIDA DE ALGODÓN 2"" X 25 YARDAS DE LONGITUD",TRAMITE USUAL,12.105000000000000426325641456060111522674560546875,416,0,0,416,5035.6800000000002910383045673370361328125
437,209559801,"MUÑEQUERA CON BARRA DE 6” U 8” DERECHA O IZQUIERA, CON CIERRE DE VELCRO  (SE SOLICITA  TAMAÑO MEDIANO)",TRAMITE USUAL,40,0,0,0,0,0
438,209559901,"MUÑEQUERA CON BARRA DE 6” U 8” DERECHA O IZQUIERA, CON CIERRE DE VELCRO, SE SOLICITA  TAMAÑO GRANDE ",TRAMITE USUAL,40.68999999999999772626324556767940521240234375,0,0,0,0,0
439,209560201,"INMOVILIZADOR DE RODILLA UNIVERSAL                                                SE SOLICITATAMAÑO 20"" DE LONGITUD",TRAMITE USUAL,44.53999999999999914734871708787977695465087890625,230,0,0,230,10244.199999999998908606357872486114501953125
440,209560301,"INMOVILIZADOR DE RODILLA UNIVERSAL   SE SOLICITA  Tamaños : 24"". de longitud",TRAMITE USUAL,40.52000000000000312638803734444081783294677734375,264,0,0,264,10697.280000000000654836185276508331298828125
441,209560401,INMOVILIZADOR ELÁSTICO DE HOMBRO SE SOLICITA TAMAÑO MEDIANO,TRAMITE USUAL,14.53999999999999914734871708787977695465087890625,706,0,0,706,10265.239999999999781721271574497222900390625
442,209564401,SUTURA POLIGLACTINA 910 RECUBIERTO DE POLIGLACTINA 370 Y TRICLOSAN (SUTURA ACTIVA).CALIBRE 1 .   (SE SOLICITA AGUJA 36.4MM Y LONGITUD DE 90CM)                                                                                                                                                                                                                 ,TRAMITE USUAL,5.36000000000000031974423109204508364200592041015625,5976,1044,4896,11916,63869.7600000000020372681319713592529296875
443,209564501,"SUTURA MONOFILAMENTO POLIDIOXANONA  CALIBRE 1                                                                                                                                                                                                                                                                                                                                                                                                                                                         DESCRIPCION: Recubierta de triclosan color violeta, longitud entre 70cm y 90cm, con aguja de 36.4mm, 40mm ó 48mm de 1/2 circulo, punta ahusada. (SE SOLICITA CALIBRE 1 CON AGUJA 40MM Y LONGITUD DE 90 CM)",TRAMITE USUAL,18.370000000000000994759830064140260219573974609375,2064,0,0,2064,37915.6800000000002910383045673370361328125
444,209565201,BANDEJA PARA CATETERIZACION VENOSO CENTRAL TRIPLE LUMEN PEDIATRICA.    SE SOLICITA MATERIAL DE CATETER CON POLIURETANO DIAMETRO 5FR X 15CM DE LONGITUD.,TRAMITE USUAL,165,0,0,0,0,0
445,209566001,"RECIPIENTE DESECHABLE PARA SISTEMA DE DRENAJE TORÁCICO DIGITAL (Se solicita recipiente de 2000, polipropileno) ",TRAMITE USUAL,135,0,0,0,0,0
446,209566101,TUBO PARA SISTEMA DE DRENAJE TORÁXICO DIGITAL CONEXIÓN SIMPLE SE SOLICITA 1.5 M,TRAMITE USUAL,27,126,360,0,486,13122
447,209566801,AGUJA PARA LA LOCALIZACION DE LESIONES MAMARIAS . SOLICITA CALIBRE 20 G A Y 10 cm                                                                                                       ,TRAMITE USUAL,10.949999999999999289457264239899814128875732421875,0,0,0,0,0
448,209585001,APÓSITO CON MATRIZ DE COLAGENO CON PLATA,TRAMITE USUAL,50,0,1480,0,1480,74000
449,209590301,TIJERA PARA BISTURI ARMONICO CON CONTROL MANUAL Y ALTA FRECUENCIA.  SE SOLICITA VASTAGO DE 45CM,TRAMITE USUAL,897.5,0,0,0,0,0
450,209603601,"RESPIRADORES CONTRA PARTICULAS DE ALTA FILTRACION N95 CON O SIN VALVULA DE EXALACION. SE SOLICITA TAMAÑO GRANDE, CON VALVULA DE EXALACIÓN ",TRAMITE USUAL,5.70000000000000017763568394002504646778106689453125,0,0,0,0,0
451,209611001,"EMPAQUES O COMPRESA CALIENTE. (SE SOLICITA TAMAÑO ESTÁNDAR DE 25CM X 30CM 10""X12"")",TRAMITE USUAL,24.489999999999998436805981327779591083526611328125,70,22,0,92,2253.079999999999927240423858165740966796875
452,209666301,ROPA DESECHABLE DE NEUROCIRUGÍA,TRAMITE USUAL,54.9500000000000028421709430404007434844970703125,0,320,0,320,17584
453,209726201,"FIJACION CUTANEO CON ADHESIVO DE SILICONA Y DOBLE PROTECCION ANTIMICROBIANA DE CLORHEXIDINA Y PLATA CON VENTANA SE SOLICITA TAMAÑO: 6cm x 7cm
",TRAMITE USUAL,18.5,4500,0,0,4500,83250
454,209726301,"FIJACION CUTANEO CON ADHESIVO DE SILICONA Y DOBLE PROTECCION ANTIMICROBIANA DE CLORHEXIDINA Y PLATA CON VENTANA SE SOLICITA TAMAÑO: 10cm x 12cm
",TRAMITE USUAL,29.5,5150,0,0,5150,151925
455,209770201,GORRO PARA VARON.,TRAMITE USUAL,0.04499999999999999833466546306226518936455249786376953125,622000,39000,60600,721600,32472
456,209770301,GORRO PARA MUJERES.,TRAMITE USUAL,0.025000000000000001387778780781445675529539585113525390625,251500,96000,0,347500,8687.5
457,209817201,ROPA DESECHABLE PARA LAPARATOMIA,TRAMITE USUAL,13.089999999999999857891452847979962825775146484375,768,0,0,768,10053.11999999999898136593401432037353515625
458,209819201,MANGA DE COMPRESION NEUMATICA SECUENCIAL Y/O INTERMITENTE PARA  PANTORRILLA PARA LA PROFILAXIS DE LA TROMBOSIS VENOSA PROFUNDA. SE SOLICITA TAMAÑO GRANDE.,TRAMITE USUAL,33.10000000000000142108547152020037174224853515625,880,40,0,920,30452
459,209819301,MANGA DE COMPRESION NEUMATICA SECUENCIAL Y/O INTERMITENTE PARA  PANTORRILLA PARA LA PROFILAXIS DE LA TROMBOSIS VENOSA PROFUNDA.    SE SOLICITA TAMAÑO  MEDIANO,TRAMITE USUAL,33.25,640,400,0,1040,34580
460,209821001,SISTEMA INTEGRADO DE CIERRE DE PUERTOS (DUAL) PARA PROCEDIMIENTOS LAPAROSCÓPICOS,TRAMITE USUAL,201.340000000000003410605131648480892181396484375,0,0,0,0,0
461,209833001,JERINGUILLA DE 1cc (μ-100) PARA INSULINA DE RETRACCION. SE SOLICITA 30G X 8MM,TRAMITE USUAL,0.38000000000000000444089209850062616169452667236328125,0,0,0,0,0
462,209833101,JERINGUILLA DE 0.5cc (¦Ì-100) PARA INSULINA DE RETRACCION     (SE SOLICITA 30G X 8MM),TRAMITE USUAL,0.330000000000000015543122344752191565930843353271484375,0,0,0,0,0
463,209833401,SET DE ROPA DESECHABLE PARA DILATACION Y CURETAJE,TRAMITE USUAL,20.4200000000000017053025658242404460906982421875,10980,512,0,11492,234666.640000000013969838619232177734375
464,209833501,FERULAS SINTETICAS EN ROLLO SE SOLICITA DE 15CM X 4.6M,TRAMITE USUAL,184.93999999999999772626324556767940521240234375,228,18,0,246,45495.2399999999979627318680286407470703125
465,209833601,"CATETER INTRAVENOSO DE BIOSEGURIDAD   (SE SOLICITA CATETER DE POLIURETANO TAMAÑO 18G X 1 1/4"")",TRAMITE USUAL,0.86999999999999999555910790149937383830547332763671875,0,38800,33200,72000,62640
466,209833701,"CATETER INTRAVENOSO DE BIOSEGURIDAD.  SE SOLICITA CATETER DE POLIURETANO TAMAÑO 20G X 1""  A 1 3/4""",TRAMITE USUAL,1.16500000000000003552713678800500929355621337890625,0,0,0,0,0
467,209833801,"CATETER INTRAVENOSO DE BIOSEGURIDAD SE SOLICITA CATETER DE POLIURETANO TAMAÑO 22G X 1 """,TRAMITE USUAL,1.064999999999999946709294817992486059665679931640625,0,0,0,0,0
468,209833901,CATETER INTRAVENOSO DE BIOSEGURIDAD 1. Catéter con sistema de seguridad de retracción automática al extraer la guía o aguja ,TRAMITE USUAL,0.82999999999999996003197111349436454474925994873046875,50800,103100,14000,167900,139357
469,209834001,CANULA NASOFARINGEA  DE 20 FR A  26 FR.  (SE SOLOCITA TAMAÑ0 26FR) ,TRAMITE USUAL,3.810000000000000053290705182007513940334320068359375,6340,0,0,6340,24155.4000000000014551915228366851806640625
470,209834201,"FILTRO DE C02 DESECHABLE (Se Solicita Con filtros de CO2 desechables (50 unidades) con su tubería según fabricante, o Con filtros de CO2 desechables (100 unidades) sin tubería según fabricante)",TRAMITE USUAL,10,0,0,0,0,0
471,209834501,SISTEMA DE DOS PIEZAS PARA COLOSTOMIA /ILEOSTOMIA PARA ADULTO ABIERTO.  (SE SOLICITO DIAMETRO EXTERNO DE 50MM),TRAMITE USUAL,4.54999999999999982236431605997495353221893310546875,0,0,0,0,0
472,209834601,SISTEMA DE DOS PIEZAS PARA COLOSTOMIA/ILEOSTONIA PARA ADULTO ABIERTA SE SOLICITA DIAMETRO EXTERNO 57MM A 60MM,TRAMITE USUAL,3.79999999999999982236431605997495353221893310546875,0,0,0,0,0
473,209834701,CANULA NASOFARINGEA  DE 32 FR A 36 FR.  (SE SOLOCITA TAMAÑ0 36FR)        ,TRAMITE USUAL,3.689999999999999946709294817992486059665679931640625,3900,0,0,3900,14391
474,209834801,ENVASE PARA DESECHOS PUNZOCORTANTE SE SOLICITA TAMAÑO 7.6 LITROS,TRAMITE USUAL,5.5,28,96,0,124,682
475,209834901,ENVASE PARA DESECHOS PUNZOCORTANTE SE SOLICITA TAMAÑO 22.7 LITROS,TRAMITE USUAL,8.5800000000000000710542735760100185871124267578125,0,0,0,0,0
476,209835001,ENVASE PARA DESECHOS PUNZOCORTANTE SE SOLICITA TAMAÑO 1.4 LITROS,TRAMITE USUAL,5.57500000000000017763568394002504646778106689453125,0,0,0,0,0
477,209847501,GUANTES DE NITRILO CON PUÑO EXTENDIDO. SE (SOLICITA TAMAÑO EXTRA GRANDE),TRAMITE USUAL,1.649999999999999911182158029987476766109466552734375,0,0,0,0,0
478,209851201,COBERTOR CÁMARA DE VIDEO (Se solicita tamaño  17CM X 242CM),TRAMITE USUAL,2.770000000000000017763568394002504646778106689453125,0,120,0,120,332.3999999999999772626324556767940521240234375
479,209854501,LAMINA PROTECTORA DE SUPERFICIES AISLANTE DE FLUIDOS CONTAMINANTES.                           ,TRAMITE USUAL,18.5,13830,9750,2800,26380,488030
480,209865701,APOSITO CON MATRIZ DE COLAGENO (Se solicita 4 pulgadas x 4 pulgadas (10cm x 10cm),TRAMITE USUAL,51.659999999999996589394868351519107818603515625,0,0,0,0,0
481,209868301,TERMOMETRO TIMPANICO DIGITAL   ( SE SOLICITA FUNDA O CUBERTOR DESECHABLE) ,TRAMITE USUAL,0.05000000000000000277555756156289135105907917022705078125,8805000,244200,65600,9114800,455740
482,209870701,"SOLUCIÓN DE GLUCONATO DE CLORHEXIDINA AL 2% Y ALCOHOL AL 70%, PARA LA ASEPSIA PRE QUIRÚRGICA DE LA PIEL Y PARA ACCESOS VASCULARES    SE SOLICITA TUBO APLICADOR CON ESPONJA DE 35ML  ENTINTADO",TRAMITE USUAL,9,0,0,0,0,0
483,209870801,CATETER DE SUCCION NASO-FARINGEA CALIBRE 14FR LONGITUD 60CM ,TRAMITE USUAL,0.25,0,0,0,0,0
484,209870901,CATETER DE SUCCION NASO-FARINGEA CALIBRE 16FR LONGITUD 60CM ,TRAMITE USUAL,0.25,0,0,0,0,0
485,209871001,CATETER DE SUCCION NASO-FARINGEA CALIBRE 18FR LONGITUD 60CM ,TRAMITE USUAL,0.25,1200,2300,0,3500,875
486,209871201,TIJERA LAPAROSCÓPICA PARA BISTURI ARMINICO CON CONTROL MANUAL Y ALTA FRECUENCIA. SE SOLICITA VASTAGO DE 17 CM ,TRAMITE USUAL,1090,0,0,0,0,0
487,209871301,"SISTEMA DE CATERIZACION VENOSA CENTRAL DE DOBLE O TRIPLE
LUMEN CON 2 ANTIBIOTICOS (MINOCICLINA Y RIFAMPICINA), NEONATAL
O PEDIÁTRICO  (SE SOLICITA DOBLE LUMEN 4FR X 5M, DE POLIURETANO)",TRAMITE USUAL,205,0,0,0,0,0
488,209871401,"SISTEMA DE CATERIZACION VENOSA CENTRAL DE DOBLE O TRIPLE
LUMEN CON 2 ANTIBIOTICOS (MINOCICLINA Y RIFAMPICINA), NEONATAL
O PEDIÁTRICO.                                                                        SE SOLICITA 5FR X 8CM, DE DOS LUMENS DE POLIURETANO",TRAMITE USUAL,205,0,0,0,0,0
489,209871501,"SISTEMA DE CATERIZACION VENOSA CENTRAL DE DOBLE O TRIPLE LUMEN CON 2 ANTIBIOTICOS (MINOCICLINA Y RIFAMPICINA), NEONATAL O PEDIÁTRICO,  SE SOLICITA 5FR X 12CM, DE POLIURETANO DE DOS LUMEN.",TRAMITE USUAL,205,0,0,0,0,0
490,209871601,"SISTEMA DE CATERIZACION VENOSA CENTRAL DE DOBLE O TRIPLE LUMEN CON 2 ANTIBIOTICOS (MINOCICLINA Y RIFAMPICINA), NEONATAL O PEDIÁTRICO.   SE SOLICITA DE TRES LUMENES 5FR X 12CM, DE POLIURETANO",TRAMITE USUAL,205,0,0,0,0,0
491,209871701,"SISTEMA DE CATERIZACION VENOSA CENTRAL DE DOBLE O TRIPLE LUMEN CON 2 ANTIBIOTICOS (MINOCICLINA Y RIFAMPICINA), NEONATAL O PEDIÁTRICO                                                                                                                                  (SE SOLICITA 5FR X 15M, TRIPLE LUMEN DE POLIURETANO)",TRAMITE USUAL,205,0,0,0,0,0
492,209871801,"SISTEMA DE CATERIZACION VENOSA CENTRAL DE DOBLE O TRIPLE LUMEN CON 2 ANTIBIOTICOS (MINOCICLINA Y RIFAMPICINA), NEONATAL
O PEDIÁTRICO.   SE SOLICITA 5FR X 8CM, DE TRES LUMENS DE POLIURETANO",TRAMITE USUAL,205,0,0,0,0,0
493,209871901,SISTEMA DE CATERIZACION VENOSA CENTRAL DE DOBLE   LUMEN CON 2 ANTIBIOTICOS 4FR X 8CM,TRAMITE USUAL,205,0,0,0,0,0
494,209872001,"TUBO DE EXTENSIÓN DE VENOCLISIS. SE SOLICITA DE 25"" DE LONGITUD",TRAMITE USUAL,0.59999999999999997779553950749686919152736663818359375,9148,400,1600,11148,6688.8000000000001818989403545856475830078125
495,209884401,"SISTEMA CERRADO (ESPIGA) UNIDIRECCIONAL PARA EXTRACCIÓN DE SOLUCION EN BOTELLA O BOLSA, CON O SIN FILTRO DE AIRE Y CONECTOR LIBRE DE AGUJA. SE SOLICITA CON FILTRO",TRAMITE USUAL,2.410000000000000142108547152020037174224853515625,2200,0,0,2200,5302
496,209910801,ESTIMULADOR NERVIO VAGO (PROTESIS) ,TRAMITE USUAL,25783.330000000001746229827404022216796875,0,0,0,0,0
497,209968301,MICROESFERAS DE POLIESTIRENO CARGADAS NEGATIVAMENTE,TRAMITE USUAL,27.280000000000001136868377216160297393798828125,886,0,0,886,24170.080000000001746229827404022216796875
498,209975301,CEPILLO PLANO PARA LIMPIEZA DE 75MM X 20MM X 15MM (RIGIDO) ,TRAMITE USUAL,25,14428,500,0,14928,373200
499,209975501,CEPILLO PARA LIMPIAR 75mm x 20mm x 15mm (FLEXIBLE),TRAMITE USUAL,25,12228,800,0,13028,325700
500,209975701,ESPONJA TEREFTALATO DE POLIETILENO      (SE SOLICITA ESPONJA),TRAMITE USUAL,0.90000000000000002220446049250313080847263336181640625,3680,0,6440,10120,9108
501,209991001,"PELICULA DE SILICONA, CON PROTECCIÓN DE CLORHEXIDINA Y PLATA SE SOLICITA TAMAÑO: 10 cm X 12 cm.",TRAMITE USUAL,35.9500000000000028421709430404007434844970703125,4350,0,100,4450,159977.5
502,209991101,"PELICULA DE SILICONA, CON PROTECCIÓN DE CLORHEXIDINA Y PLATA SE SOLICITA TAMAÑO: 6 cm X 20 cm.",TRAMITE USUAL,29.5,0,0,0,0,0
503,209991201,"APOSITO PROTECTOR, SE SOLICITA TAMAÑO 15CM X 15CM",TRAMITE USUAL,23.375,200,1360,0,1560,36465
504,209991301,"APOSITO PROTECTOR, SE SOLICITA TAMAÑO 20CM X 20CM",TRAMITE USUAL,37.0799999999999982946974341757595539093017578125,0,0,0,0,0
505,209991401,"APOSITO ESPUMA , SE SOLICITA Tamaños con borde, 12.5X 12.5 CM",TRAMITE USUAL,33,0,160,0,160,5280
506,209991501,"APOSITO ESPUMA, se solicita Tamaños sin borde 10CM X 20CM",TRAMITE USUAL,27,0,120,0,120,3240
507,209991801,"APOSITO ESPUMA , se solicita Tamaños con borde 20CMX 26CM PARA TALON.",TRAMITE USUAL,58.60000000000000142108547152020037174224853515625,0,0,0,0,0
508,209992601,ESTABILIZADOR DE CATETER SUPRA PUBICO O URETERAL,TRAMITE USUAL,22,0,0,0,0,0
509,,Total general,"",,37466870,2186684,1643492,41297046,34314563.9524099826812744140625
